xxyyx(yx)xyyxy = xxyyx(xy)xyyxy
xxyyx(yx)xyyyx = xxyyx(xy)xyyyx
xxyyx(yx)yxxyy = xxyyx(xy)yxxyy
xxyyyx(yx)xyyx = xxyyyx(xy)xyyx
xxyyyx(yx)yxxy = xxyyyx(xy)yxxy
xyxxxyy(yx)yxy = xyxxxyy(xy)yxy
xyxxy(yx)xyyxy = xyxxy(xy)xyyxy
xyxxy(yx)xyyyx = xyxxy(xy)xyyyx
xyxxy(yx)yxxyy = xyxxy(xy)yxxyy
xyx(yx)xxyyyxy = xyx(xy)xxyyyxy
xyx(yx)xxyyyyx = xyx(xy)xxyyyyx
xyxyyx(yx)xyyx = xyxyyx(xy)xyyx
xyxyyx(yx)yxxy = xyxyyx(xy)yxxy
xyxy(yx)yyxxxy = xyxy(xy)yyxxxy
xyyxxy(yx)xyyx = xyyxxy(xy)xyyx
xyyxxy(yx)yxxy = xyyxxy(xy)yxxy
xyyx(yx)xxyyyx = xyyx(xy)xxyyyx
xyyx(yx)xyxyyx = xyyx(xy)xyxyyx
xyyx(yxxy)xyyx = xyyx(xyyx)xyyx
xyyx(yx)xyyxxy = xyyx(xy)xyyxxy
xyyx(yxxy)yxxy = xyyx(xyyx)yxxy
xyyx(yx)xyyxyx = xyyx(xy)xyyxyx
xyyx(yx)xyyyxx = xyyx(xy)xyyyxx
xyyx(yx)yxxxyy = xyyx(xy)yxxxyy
xyyx(yx)yxxyxy = xyyx(xy)yxxyxy
xyyx(yxyx)xyyx = xyyx(xyxy)xyyx
xyyx(yx)yxxyyx = xyyx(xy)yxxyyx
xyyxyx(yx)xyyx = xyyxyx(xy)xyyx
xyyx(yxyx)yxxy = xyyx(xyxy)yxxy
xyyx(yx)yxyxxy = xyyx(xy)yxyxxy
xyyxyx(yx)yxxy = xyyxyx(xy)yxxy
xyyx(yx)yyxxxy = xyyx(xy)yyxxxy
xyyyxx(yx)xyxy = xyyyxx(xy)xyxy
xyyyxx(yx)xyyx = xyyyxx(xy)xyyx
xyyyxx(yx)yxxy = xyyyxx(xy)yxxy
xyyyx(yx)xyyxx = xyyyx(xy)xyyxx
xyyyx(yx)yxxxy = xyyyx(xy)yxxxy
xyyyx(yx)yxxyx = xyyyx(xy)yxxyx
xyyyyxx(yx)xyx = xyyyyxx(xy)xyx
