xxxxyyyyx(yx)yxy = xxxxyyyyx(xy)yxy
xxxyxxyy(yx)yxyy = xxxyxxyy(xy)yxyy
xxxyxy(yx)xyyyyx = xxxyxy(xy)xyyyyx
xxxyyx(yx)xyyxyy = xxxyyx(xy)xyyxyy
xxxyyx(yx)xyyyxy = xxxyyx(xy)xyyyxy
xxxyyx(yx)xyyyyx = xxxyyx(xy)xyyyyx
xxxyyx(yx)yxxyyy = xxxyyx(xy)yxxyyy
xxxyyxy(yx)yyxxy = xxxyyxy(xy)yyxxy
xxxyyyx(yx)xyyxy = xxxyyyx(xy)xyyxy
xxxyyyx(yx)xyyyx = xxxyyyx(xy)xyyyx
xxxyyyx(yx)yxxyy = xxxyyyx(xy)yxxyy
xxxyyyx(yx)yxyxy = xxxyyyx(xy)yxyxy
xxxyyyx(yx)yyxxy = xxxyyyx(xy)yyxxy
xxxyyyyx(yx)xyyx = xxxyyyyx(xy)xyyx
xxxyyyyx(yx)yxxy = xxxyyyyx(xy)yxxy
xxxyyyyx(yx)yxyx = xxxyyyyx(xy)yxyx
xxyxxxyy(yx)yxyy = xxyxxxyy(xy)yxyy
xxyxxy(yx)xyyxyy = xxyxxy(xy)xyyxyy
xxyxxy(yx)xyyyxy = xxyxxy(xy)xyyyxy
xxyxxy(yx)xyyyyx = xxyxxy(xy)xyyyyx
xxyxxy(yx)yxxyyy = xxyxxy(xy)yxxyyy
xxyxxyy(yx)xyyyx = xxyxxyy(xy)xyyyx
xxyxxyy(yx)yxyyx = xxyxxyy(xy)yxyyx
xxyxxyy(yx)yyxxy = xxyxxyy(xy)yyxxy
xxyx(yx)xxyyxyyy = xxyx(xy)xxyyxyyy
xxyx(yx)xxyyyxyy = xxyx(xy)xxyyyxyy
xxyx(yx)xxyyyyxy = xxyx(xy)xxyyyyxy
xxyx(yx)xxyyyyyx = xxyx(xy)xxyyyyyx
xxyxyxy(yx)xyyyx = xxyxyxy(xy)xyyyx
xxyxy(yx)xyyyyxx = xxyxy(xy)xyyyyxx
xxyxyyx(yx)xyyxy = xxyxyyx(xy)xyyxy
xxyxyyx(yx)xyyyx = xxyxyyx(xy)xyyyx
xxyxyyx(yx)yxxyy = xxyxyyx(xy)yxxyy
xxyxy(yx)yyxxxyy = xxyxy(xy)yyxxxyy
xxyxyyyx(yx)xyyx = xxyxyyyx(xy)xyyx
xxyxyyyx(yx)yxxy = xxyxyyyx(xy)yxxy
xxyyxxxyy(yx)yxy = xxyyxxxyy(xy)yxy
xxyyxxy(yx)xyyxy = xxyyxxy(xy)xyyxy
xxyyxxy(yx)xyyyx = xxyyxxy(xy)xyyyx
xxyyxxy(yx)yxxyy = xxyyxxy(xy)yxxyy
xxyyx(yx)xxyyyxy = xxyyx(xy)xxyyyxy
xxyyx(yx)xxyyyyx = xxyyx(xy)xxyyyyx
xxyyx(yx)xyxyyxy = xxyyx(xy)xyxyyxy
xxyyx(yxxy)xyyxy = xxyyx(xyyx)xyyxy
xxyyx(yx)xyxyyyx = xxyyx(xy)xyxyyyx
xxyyx(yxxy)xyyyx = xxyyx(xyyx)xyyyx
xxyyx(yx)xyyxxyy = xxyyx(xy)xyyxxyy
xxyyx(yxxy)yxxyy = xxyyx(xyyx)yxxyy
xxyyx(yx)xyyxyxy = xxyyx(xy)xyyxyxy
xxyyx(yx)xyyxyyx = xxyyx(xy)xyyxyyx
xxyyx(yx)xyyyxxy = xxyyx(xy)xyyyxxy
xxyyx(yx)xyyyxyx = xxyyx(xy)xyyyxyx
xxyyx(yx)xyyyyxx = xxyyx(xy)xyyyyxx
xxyyx(yx)yxxxyyy = xxyyx(xy)yxxxyyy
xxyyx(yx)yxxyxyy = xxyyx(xy)yxxyxyy
xxyyx(yxyx)xyyxy = xxyyx(xyxy)xyyxy
xxyyx(yx)yxxyyxy = xxyyx(xy)yxxyyxy
xxyyxyx(yx)xyyxy = xxyyxyx(xy)xyyxy
xxyyx(yxyx)xyyyx = xxyyx(xyxy)xyyyx
xxyyx(yx)yxxyyyx = xxyyx(xy)yxxyyyx
xxyyxyx(yx)xyyyx = xxyyxyx(xy)xyyyx
xxyyx(yxyx)yxxyy = xxyyx(xyxy)yxxyy
xxyyx(yx)yxyxxyy = xxyyx(xy)yxyxxyy
xxyyxyx(yx)yxxyy = xxyyxyx(xy)yxxyy
xxyyx(yx)yyxxxyy = xxyyx(xy)yyxxxyy
xxyyxyyx(yx)xyyx = xxyyxyyx(xy)xyyx
xxyyxyyx(yx)yxxy = xxyyxyyx(xy)yxxy
xxyyxy(yx)yyxxxy = xxyyxy(xy)yyxxxy
xxyyxy(yx)yyxxyx = xxyyxy(xy)yyxxyx
xxyyyxx(yx)xyxyy = xxyyyxx(xy)xyxyy
xxyyyxx(yx)xyyxy = xxyyyxx(xy)xyyxy
xxyyyxx(yx)xyyyx = xxyyyxx(xy)xyyyx
xxyyyxx(yx)yxxyy = xxyyyxx(xy)yxxyy
xxyyyxxy(yx)xyyx = xxyyyxxy(xy)xyyx
xxyyyxxy(yx)yxxy = xxyyyxxy(xy)yxxy
xxyyyx(yxx)xyyyx = xxyyyx(xxy)xyyyx
xxyyyx(yx)xxyyyx = xxyyyx(xy)xxyyyx
xxyyyx(yx)xyxyyx = xxyyyx(xy)xyxyyx
xxyyyx(yxxy)xyyx = xxyyyx(xyyx)xyyx
xxyyyx(yx)xyyxxy = xxyyyx(xy)xyyxxy
xxyyyx(yxxy)yxxy = xxyyyx(xyyx)yxxy
xxyyyx(yx)xyyxyx = xxyyyx(xy)xyyxyx
xxyyyx(yx)xyyyxx = xxyyyx(xy)xyyyxx
xxyyyx(yx)yxxxyy = xxyyyx(xy)yxxxyy
xxyyyx(yx)yxxyxy = xxyyyx(xy)yxxyxy
xxyyyx(yxyx)xyyx = xxyyyx(xyxy)xyyx
xxyyyx(yx)yxxyyx = xxyyyx(xy)yxxyyx
xxyyyxyx(yx)xyyx = xxyyyxyx(xy)xyyx
xxyyyx(yxyx)yxxy = xxyyyx(xyxy)yxxy
xxyyyx(yx)yxyxxy = xxyyyx(xy)yxyxxy
xxyyyxyx(yx)yxxy = xxyyyxyx(xy)yxxy
xxyyyx(yx)yxyxyx = xxyyyx(xy)yxyxyx
xxyyyx(yx)yyxxxy = xxyyyx(xy)yyxxxy
xxyyyx(yx)yyxxyx = xxyyyx(xy)yyxxyx
xxyyyyxx(yx)xyxy = xxyyyyxx(xy)xyxy
xxyyyyxx(yx)xyyx = xxyyyyxx(xy)xyyx
xxyyyyxx(yx)yxxy = xxyyyyxx(xy)yxxy
xxyyyyx(yx)xyyxx = xxyyyyx(xy)xyyxx
xxyyyyx(yx)yxxxy = xxyyyyx(xy)yxxxy
xxyyyyx(yx)yxxyx = xxyyyyx(xy)yxxyx
xxyyyyx(yx)yxyxx = xxyyyyx(xy)yxyxx
xxyyyyyxx(yx)xyx = xxyyyyyxx(xy)xyx
xyxxxxyy(yx)yxyy = xyxxxxyy(xy)yxyy
xyxxxxyyy(yx)yxy = xyxxxxyyy(xy)yxy
xyxxxyxyy(yx)yxy = xyxxxyxyy(xy)yxy
xyxxxy(yx)xyyxyy = xyxxxy(xy)xyyxyy
xyxxxy(yx)xyyyxy = xyxxxy(xy)xyyyxy
xyxxxy(yx)xyyyyx = xyxxxy(xy)xyyyyx
xyxxxy(yx)yxxyyy = xyxxxy(xy)yxxyyy
xyxxxyy(yx)xyyxy = xyxxxyy(xy)xyyxy
xyxxxyy(yx)xyyyx = xyxxxyy(xy)xyyyx
xyxxxyy(yx)yxxyy = xyxxxyy(xy)yxxyy
xyxxxyy(yx)yxyxy = xyxxxyy(xy)yxyxy
xyxxxyy(yx)yxyyx = xyxxxyy(xy)yxyyx
xyxxxyy(yx)yyxxy = xyxxxyy(xy)yyxxy
xyxxyxxyy(yx)yxy = xyxxyxxyy(xy)yxy
xyxxyxy(yx)xyyxy = xyxxyxy(xy)xyyxy
xyxxyxy(yx)xyyyx = xyxxyxy(xy)xyyyx
xyxxyxy(yx)yxxyy = xyxxyxy(xy)yxxyy
xyxxy(yx)xxyyyxy = xyxxy(xy)xxyyyxy
xyxxy(yx)xxyyyyx = xyxxy(xy)xxyyyyx
xyxxy(yx)xyxyyxy = xyxxy(xy)xyxyyxy
xyxxy(yxxy)xyyxy = xyxxy(xyyx)xyyxy
xyxxy(yx)xyxyyyx = xyxxy(xy)xyxyyyx
xyxxy(yxxy)xyyyx = xyxxy(xyyx)xyyyx
xyxxy(yx)xyyxxyy = xyxxy(xy)xyyxxyy
xyxxy(yxxy)yxxyy = xyxxy(xyyx)yxxyy
xyxxy(yx)xyyxyxy = xyxxy(xy)xyyxyxy
xyxxy(yx)xyyxyyx = xyxxy(xy)xyyxyyx
xyxxy(yx)xyyyxxy = xyxxy(xy)xyyyxxy
xyxxy(yx)xyyyxyx = xyxxy(xy)xyyyxyx
xyxxy(yx)xyyyyxx = xyxxy(xy)xyyyyxx
xyxxy(yx)yxxxyyy = xyxxy(xy)yxxxyyy
xyxxy(yx)yxxyxyy = xyxxy(xy)yxxyxyy
xyxxy(yxyx)xyyxy = xyxxy(xyxy)xyyxy
xyxxy(yx)yxxyyxy = xyxxy(xy)yxxyyxy
xyxxyyx(yx)xyyxy = xyxxyyx(xy)xyyxy
xyxxy(yxyx)xyyyx = xyxxy(xyxy)xyyyx
xyxxy(yx)yxxyyyx = xyxxy(xy)yxxyyyx
xyxxyyx(yx)xyyyx = xyxxyyx(xy)xyyyx
xyxxy(yxyx)yxxyy = xyxxy(xyxy)yxxyy
xyxxy(yx)yxyxxyy = xyxxy(xy)yxyxxyy
xyxxyyx(yx)yxxyy = xyxxyyx(xy)yxxyy
xyxxy(yx)yyxxxyy = xyxxy(xy)yyxxxyy
xyxxyy(yx)xyyyxx = xyxxyy(xy)xyyyxx
xyxxyyyx(yx)xyyx = xyxxyyyx(xy)xyyx
xyxxyyyx(yx)yxxy = xyxxyyyx(xy)yxxy
xyxxyy(yx)yxyyxx = xyxxyy(xy)yxyyxx
xyxxyy(yx)yyxxxy = xyxxyy(xy)yyxxxy
xyxxyy(yx)yyxxyx = xyxxyy(xy)yyxxyx
xyx(yx)xxxyyyyxy = xyx(xy)xxxyyyyxy
xyx(yx)xxxyyyyyx = xyx(xy)xxxyyyyyx
xyx(yx)xxyxyyyxy = xyx(xy)xxyxyyyxy
xyx(yx)xxyxyyyyx = xyx(xy)xxyxyyyyx
xyx(yx)xxyyxyyxy = xyx(xy)xxyyxyyxy
xyx(yxxxyyxy)yxy = xyx(xyxxyyyx)yxy
xyx(yx)xxyyxyyyx = xyx(xy)xxyyxyyyx
xyx(yx)xxyyyxxyy = xyx(xy)xxyyyxxyy
xyx(yxxxyyyx)yxy = xyx(xyxxyyxy)yxy
xyx(yx)xxyyyxyxy = xyx(xy)xxyyyxyxy
xyxyxxxyy(yx)yxy = xyxyxxxyy(xy)yxy
xyx(yx)xxyyyxyyx = xyx(xy)xxyyyxyyx
xyx(yx)xxyyyyxxy = xyx(xy)xxyyyyxxy
xyx(yx)xxyyyyxyx = xyx(xy)xxyyyyxyx
xyx(yx)xxyyyyyxx = xyx(xy)xxyyyyyxx
xyxyxxy(yx)xyyxy = xyxyxxy(xy)xyyxy
xyxyxxy(yx)xyyyx = xyxyxxy(xy)xyyyx
xyxyxxy(yx)yxxyy = xyxyxxy(xy)yxxyy
xyx(yx)yxxxxyyyy = xyx(xy)yxxxxyyyy
xyxyx(yx)xxyyyxy = xyxyx(xy)xxyyyxy
xyxyx(yx)xxyyyyx = xyxyx(xy)xxyyyyx
xyxyx(yx)yxxxyyy = xyxyx(xy)yxxxyyy
xyxyxy(yx)xyyyxx = xyxyxy(xy)xyyyxx
xyxyxyyx(yx)xyyx = xyxyxyyx(xy)xyyx
xyxyxyyx(yx)yxxy = xyxyxyyx(xy)yxxy
xyxyxy(yx)yyxxxy = xyxyxy(xy)yyxxxy
xyxyyxxy(yx)xyyx = xyxyyxxy(xy)xyyx
xyxyyxxy(yx)yxxy = xyxyyxxy(xy)yxxy
xyxy(yx)xyyyyxxx = xyxy(xy)xyyyyxxx
xyxyyx(yx)xxyyyx = xyxyyx(xy)xxyyyx
xyxyyx(yx)xyxyyx = xyxyyx(xy)xyxyyx
xyxyyx(yxxy)xyyx = xyxyyx(xyyx)xyyx
xyxyyx(yx)xyyxxy = xyxyyx(xy)xyyxxy
xyxyyx(yxxy)yxxy = xyxyyx(xyyx)yxxy
xyxyyx(yx)xyyxyx = xyxyyx(xy)xyyxyx
xyxyyx(yx)xyyyxx = xyxyyx(xy)xyyyxx
xyxyyx(yx)yxxxyy = xyxyyx(xy)yxxxyy
xyxyyx(yx)yxxyxy = xyxyyx(xy)yxxyxy
xyxyyx(yxyx)xyyx = xyxyyx(xyxy)xyyx
xyxyyx(yx)yxxyyx = xyxyyx(xy)yxxyyx
xyxyyxyx(yx)xyyx = xyxyyxyx(xy)xyyx
xyxyyx(yxyx)yxxy = xyxyyx(xyxy)yxxy
xyxyyx(yx)yxyxxy = xyxyyx(xy)yxyxxy
xyxyyxyx(yx)yxxy = xyxyyxyx(xy)yxxy
xyxyyx(yx)yyxxxy = xyxyyx(xy)yyxxxy
xyxy(yx)yyxxxxyy = xyxy(xy)yyxxxxyy
xyxy(yx)yyxxxyxy = xyxy(xy)yyxxxyxy
xyxy(yx)yyxxxyyx = xyxy(xy)yyxxxyyx
xyxy(yx)yyxxyxxy = xyxy(xy)yyxxyxxy
xyxy(yx)yyxyxxxy = xyxy(xy)yyxyxxxy
xyxy(yx)yyyxxxxy = xyxy(xy)yyyxxxxy
xyxyyyxx(yx)xyxy = xyxyyyxx(xy)xyxy
xyxyyyxx(yx)xyyx = xyxyyyxx(xy)xyyx
xyxyyyxx(yx)yxxy = xyxyyyxx(xy)yxxy
xyxyyyx(yx)xyyxx = xyxyyyx(xy)xyyxx
xyxyyyx(yx)yxxxy = xyxyyyx(xy)yxxxy
xyxyyyx(yx)yxxyx = xyxyyyx(xy)yxxyx
xyxyyyyxx(yx)xyx = xyxyyyyxx(xy)xyx
xyyxxxxyy(yx)yxy = xyyxxxxyy(xy)yxy
xyyxxxy(yx)xyyxy = xyyxxxy(xy)xyyxy
xyyxxxy(yx)xyyyx = xyyxxxy(xy)xyyyx
xyyxxxy(yx)yxxyy = xyyxxxy(xy)yxxyy
xyyxxxyy(yx)xyyx = xyyxxxyy(xy)xyyx
xyyxxxyy(yx)yxxy = xyyxxxyy(xy)yxxy
xyyxxxyy(yx)yxyx = xyyxxxyy(xy)yxyx
xyyxx(yx)xxyyxyy = xyyxx(xy)xxyyxyy
xyyxx(yx)xxyyyxy = xyyxx(xy)xxyyyxy
xyyxx(yx)xxyyyyx = xyyxx(xy)xxyyyyx
xyyxx(yx)xyxxyyy = xyyxx(xy)xyxxyyy
xyyxx(yx)yxxxyyy = xyyxx(xy)yxxxyyy
xyyxxyxy(yx)xyyx = xyyxxyxy(xy)xyyx
xyyxxyxy(yx)yxxy = xyyxxyxy(xy)yxxy
xyyxxy(yx)xxyyyx = xyyxxy(xy)xxyyyx
xyyxxy(yx)xyxyyx = xyyxxy(xy)xyxyyx
xyyxxy(yxxy)xyyx = xyyxxy(xyyx)xyyx
xyyxxy(yx)xyyxxy = xyyxxy(xy)xyyxxy
xyyxxy(yxxy)yxxy = xyyxxy(xyyx)yxxy
xyyxxy(yx)xyyxyx = xyyxxy(xy)xyyxyx
xyyxxy(yx)xyyyxx = xyyxxy(xy)xyyyxx
xyyxxy(yx)yxxxyy = xyyxxy(xy)yxxxyy
xyyxxy(yx)yxxyxy = xyyxxy(xy)yxxyxy
xyyxxy(yxyx)xyyx = xyyxxy(xyxy)xyyx
xyyxxy(yx)yxxyyx = xyyxxy(xy)yxxyyx
xyyxxyyx(yx)xyyx = xyyxxyyx(xy)xyyx
xyyxxy(yxyx)yxxy = xyyxxy(xyxy)yxxy
xyyxxy(yx)yxyxxy = xyyxxy(xy)yxyxxy
xyyxxyyx(yx)yxxy = xyyxxyyx(xy)yxxy
xyyxxy(yx)yyxxxy = xyyxxy(xy)yyxxxy
xyyx(yxx)xxyyyyx = xyyx(xxy)xxyyyyx
xyyx(yx)xxxyyyyx = xyyx(xy)xxxyyyyx
xyyx(yx)xxyxyyyx = xyyx(xy)xxyxyyyx
xyyx(yx)xxyyxyyx = xyyx(xy)xxyyxyyx
xyyx(yx)xxyyyxxy = xyyx(xy)xxyyyxxy
xyyx(yx)xxyyyxyx = xyyx(xy)xxyyyxyx
xyyx(yx)xxyyyyxx = xyyx(xy)xxyyyyxx
xyyx(yx)xyxxyyyx = xyyx(xy)xyxxyyyx
xyyx(yxxy)xxyyyx = xyyx(xyyx)xxyyyx
xyyx(yx)xyxyxyyx = xyyx(xy)xyxyxyyx
xyyx(yxxyxy)xyyx = xyyx(xyxyyx)xyyx
xyyx(yxxy)xyxyyx = xyyx(xyyx)xyxyyx
xyyx(yxxyxy)xyyx = xyyx(xyyxyx)xyyx
xyyx(yx)xyxyyxxy = xyyx(xy)xyxyyxxy
xyyx(yxxyxy)yxxy = xyyx(xyxyyx)yxxy
xyyx(yxxy)xyyxxy = xyyx(xyyx)xyyxxy
xyyx(yxxyxy)yxxy = xyyx(xyyxyx)yxxy
xyyx(yx)xyxyyxyx = xyyx(xy)xyxyyxyx
xyyx(yxxy)xyyxyx = xyyx(xyyx)xyyxyx
xyyx(yx)xyxyyyxx = xyyx(xy)xyxyyyxx
xyyx(yxxy)xyyyxx = xyyx(xyyx)xyyyxx
xyyx(yx)xyyxxxyy = xyyx(xy)xyyxxxyy
xyyx(yxxy)yxxxyy = xyyx(xyyx)yxxxyy
xyyx(yx)xyyxxyxy = xyyx(xy)xyyxxyxy
xyyx(yxxy)yxxyxy = xyyx(xyyx)yxxyxy
xyyx(yxxyyx)xyyx = xyyx(xyxyxy)xyyx
xyyx(yx)xyyxxyyx = xyyx(xy)xyyxxyyx
xyyx(yxxyyx)xyyx = xyyx(xyyxxy)xyyx
xyyx(yxxy)yxxyyx = xyyx(xyyx)yxxyyx
xyyxyxxy(yx)xyyx = xyyxyxxy(xy)xyyx
xyyx(yxxyyx)yxxy = xyyx(xyxyxy)yxxy
xyyx(yx)xyyxyxxy = xyyx(xy)xyyxyxxy
xyyx(yxxyyx)yxxy = xyyx(xyyxxy)yxxy
xyyx(yxxy)yxyxxy = xyyx(xyyx)yxyxxy
xyyxyxxy(yx)yxxy = xyyxyxxy(xy)yxxy
xyyx(yx)xyyxyxyx = xyyx(xy)xyyxyxyx
xyyx(yx)xyyxyyxx = xyyx(xy)xyyxyyxx
xyyx(yx)xyyyxxxy = xyyx(xy)xyyyxxxy
xyyx(yxxy)yyxxxy = xyyx(xyyx)yyxxxy
xyyx(yx)xyyyxxyx = xyyx(xy)xyyyxxyx
xyyx(yx)xyyyxyxx = xyyx(xy)xyyyxyxx
xyyx(yx)xyyyyxxx = xyyx(xy)xyyyyxxx
xyyx(yx)yxxxxyyy = xyyx(xy)yxxxxyyy
xyyx(yx)yxxxyxyy = xyyx(xy)yxxxyxyy
xyyx(yx)yxxxyyxy = xyyx(xy)yxxxyyxy
xyyx(yxyx)xxyyyx = xyyx(xyxy)xxyyyx
xyyx(yx)yxxxyyyx = xyyx(xy)yxxxyyyx
xyyxyx(yx)xxyyyx = xyyxyx(xy)xxyyyx
xyyx(yx)yxxyxxyy = xyyx(xy)yxxyxxyy
xyyx(yx)yxxyxyxy = xyyx(xy)yxxyxyxy
xyyx(yxyx)xyxyyx = xyyx(xyxy)xyxyyx
xyyx(yxyxxy)xyyx = xyyx(xyxyyx)xyyx
xyyx(yx)yxxyxyyx = xyyx(xy)yxxyxyyx
xyyx(yxyxxy)xyyx = xyyx(xyyxyx)xyyx
xyyxyx(yx)xyxyyx = xyyxyx(xy)xyxyyx
xyyxyx(yxxy)xyyx = xyyxyx(xyyx)xyyx
xyyx(yxyx)xyyxxy = xyyx(xyxy)xyyxxy
xyyx(yxyxxy)yxxy = xyyx(xyxyyx)yxxy
xyyx(yx)yxxyyxxy = xyyx(xy)yxxyyxxy
xyyx(yxyxxy)yxxy = xyyx(xyyxyx)yxxy
xyyxyx(yx)xyyxxy = xyyxyx(xy)xyyxxy
xyyxyx(yxxy)yxxy = xyyxyx(xyyx)yxxy
xyyx(yxyx)xyyxyx = xyyx(xyxy)xyyxyx
xyyx(yx)yxxyyxyx = xyyx(xy)yxxyyxyx
xyyxyx(yx)xyyxyx = xyyxyx(xy)xyyxyx
xyyx(yxyx)xyyyxx = xyyx(xyxy)xyyyxx
xyyx(yx)yxxyyyxx = xyyx(xy)yxxyyyxx
xyyxyx(yx)xyyyxx = xyyxyx(xy)xyyyxx
xyyx(yxyx)yxxxyy = xyyx(xyxy)yxxxyy
xyyx(yx)yxyxxxyy = xyyx(xy)yxyxxxyy
xyyxyx(yx)yxxxyy = xyyxyx(xy)yxxxyy
xyyx(yxyx)yxxyxy = xyyx(xyxy)yxxyxy
xyyx(yx)yxyxxyxy = xyyx(xy)yxyxxyxy
xyyxyx(yx)yxxyxy = xyyxyx(xy)yxxyxy
xyyx(yxyxyx)xyyx = xyyx(xyxyxy)xyyx
xyyx(yxyx)yxxyyx = xyyx(xyxy)yxxyyx
xyyx(yxyxyx)xyyx = xyyx(xyyxxy)xyyx
xyyx(yx)yxyxxyyx = xyyx(xy)yxyxxyyx
xyyxyx(yxyx)xyyx = xyyxyx(xyxy)xyyx
xyyxyx(yx)yxxyyx = xyyxyx(xy)yxxyyx
xyyxyxyx(yx)xyyx = xyyxyxyx(xy)xyyx
xyyx(yxyxyx)yxxy = xyyx(xyxyxy)yxxy
xyyx(yxyx)yxyxxy = xyyx(xyxy)yxyxxy
xyyx(yxyxyx)yxxy = xyyx(xyyxxy)yxxy
xyyx(yx)yxyxyxxy = xyyx(xy)yxyxyxxy
xyyxyx(yxyx)yxxy = xyyxyx(xyxy)yxxy
xyyxyx(yx)yxyxxy = xyyxyx(xy)yxyxxy
xyyxyxyx(yx)yxxy = xyyxyxyx(xy)yxxy
xyyx(yxyx)yyxxxy = xyyx(xyxy)yyxxxy
xyyx(yx)yxyyxxxy = xyyx(xy)yxyyxxxy
xyyxyx(yx)yyxxxy = xyyxyx(xy)yyxxxy
xyyx(yx)yyxxxxyy = xyyx(xy)yyxxxxyy
xyyx(yx)yyxxxyxy = xyyx(xy)yyxxxyxy
xyyx(yx)yyxxxyyx = xyyx(xy)yyxxxyyx
xyyx(yx)yyxxyxxy = xyyx(xy)yyxxyxxy
xyyx(yx)yyxyxxxy = xyyx(xy)yyxyxxxy
xyyx(yx)yyyxxxxy = xyyx(xy)yyyxxxxy
xyyxyyxx(yx)xyxy = xyyxyyxx(xy)xyxy
xyyxyyxx(yx)xyyx = xyyxyyxx(xy)xyyx
xyyxyyxx(yx)yxxy = xyyxyyxx(xy)yxxy
xyyxyyx(yx)xyyxx = xyyxyyx(xy)xyyxx
xyyxyyx(yx)yxxxy = xyyxyyx(xy)yxxxy
xyyxyyx(yx)yxxyx = xyyxyyx(xy)yxxyx
xyyx(yyx)yyxxxxy = xyyx(xyy)yyxxxxy
xyyxy(yx)yyxxxxy = xyyxy(xy)yyxxxxy
xyyxy(yx)yyxxxyx = xyyxy(xy)yyxxxyx
xyyxy(yx)yyxxyxx = xyyxy(xy)yyxxyxx
xyyxyyyxx(yx)xyx = xyyxyyyxx(xy)xyx
xyyyxxxy(yx)xyyx = xyyyxxxy(xy)xyyx
xyyyxxxy(yx)yxxy = xyyyxxxy(xy)yxxy
xyyyxx(yx)xxyyxy = xyyyxx(xy)xxyyxy
xyyyxx(yx)xxyyyx = xyyyxx(xy)xxyyyx
xyyyxx(yx)xyxxyy = xyyyxx(xy)xyxxyy
xyyyxx(yx)xyxyxy = xyyyxx(xy)xyxyxy
xyyyxx(yx)xyxyyx = xyyyxx(xy)xyxyyx
xyyyxx(yxxy)xyyx = xyyyxx(xyyx)xyyx
xyyyxx(yx)xyyxxy = xyyyxx(xy)xyyxxy
xyyyxx(yxxy)yxxy = xyyyxx(xyyx)yxxy
xyyyxx(yx)xyyxyx = xyyyxx(xy)xyyxyx
xyyyxx(yx)xyyyxx = xyyyxx(xy)xyyyxx
xyyyxx(yx)yxxxyy = xyyyxx(xy)yxxxyy
xyyyxx(yx)yxxyxy = xyyyxx(xy)yxxyxy
xyyyxx(yxyx)xyyx = xyyyxx(xyxy)xyyx
xyyyxx(yx)yxxyyx = xyyyxx(xy)yxxyyx
xyyyxxyx(yx)xyyx = xyyyxxyx(xy)xyyx
xyyyxx(yxyx)yxxy = xyyyxx(xyxy)yxxy
xyyyxx(yx)yxyxxy = xyyyxx(xy)yxyxxy
xyyyxxyx(yx)yxxy = xyyyxxyx(xy)yxxy
xyyyxx(yx)yyxxxy = xyyyxx(xy)yyxxxy
xyyyxxy(yx)xyyxx = xyyyxxy(xy)xyyxx
xyyyxx(yyx)yxxxy = xyyyxx(xyy)yxxxy
xyyyxxy(yx)yxxxy = xyyyxxy(xy)yxxxy
xyyyxxy(yx)yxxyx = xyyyxxy(xy)yxxyx
xyyyx(yxx)xyyyxx = xyyyx(xxy)xyyyxx
xyyyx(yx)xxyyyxx = xyyyx(xy)xxyyyxx
xyyyxyxx(yx)xyxy = xyyyxyxx(xy)xyxy
xyyyxyxx(yx)xyyx = xyyyxyxx(xy)xyyx
xyyyxyxx(yx)yxxy = xyyyxyxx(xy)yxxy
xyyyx(yx)xyxyyxx = xyyyx(xy)xyxyyxx
xyyyx(yxxy)xyyxx = xyyyx(xyyx)xyyxx
xyyyx(yxx)yyxxxy = xyyyx(xxy)yyxxxy
xyyyx(yx)xyyxxxy = xyyyx(xy)xyyxxxy
xyyyx(yxxy)yxxxy = xyyyx(xyyx)yxxxy
xyyyx(yx)xyyxxyx = xyyyx(xy)xyyxxyx
xyyyx(yxxy)yxxyx = xyyyx(xyyx)yxxyx
xyyyx(yx)xyyxyxx = xyyyx(xy)xyyxyxx
xyyyx(yx)xyyyxxx = xyyyx(xy)xyyyxxx
xyyyx(yx)yxxxxyy = xyyyx(xy)yxxxxyy
xyyyx(yx)yxxxyxy = xyyyx(xy)yxxxyxy
xyyyx(yx)yxxxyyx = xyyyx(xy)yxxxyyx
xyyyx(yx)yxxyxxy = xyyyx(xy)yxxyxxy
xyyyx(yx)yxxyxyx = xyyyx(xy)yxxyxyx
xyyyx(yxyx)xyyxx = xyyyx(xyxy)xyyxx
xyyyx(yx)yxxyyxx = xyyyx(xy)yxxyyxx
xyyyxyx(yx)xyyxx = xyyyxyx(xy)xyyxx
xyyyx(yxyx)yxxxy = xyyyx(xxyy)yxxxy
xyyyx(yxyx)yxxxy = xyyyx(xyxy)yxxxy
xyyyx(yx)yxyxxxy = xyyyx(xy)yxyxxxy
xyyyxyx(yx)yxxxy = xyyyxyx(xy)yxxxy
xyyyx(yxyx)yxxyx = xyyyx(xyxy)yxxyx
xyyyx(yx)yxyxxyx = xyyyx(xy)yxyxxyx
xyyyxyx(yx)yxxyx = xyyyxyx(xy)yxxyx
xyyyx(yx)yxyxyxx = xyyyx(xy)yxyxyxx
xyyyx(yx)yyxxxxy = xyyyx(xy)yyxxxxy
xyyyx(yx)yyxxxyx = xyyyx(xy)yyxxxyx
xyyyx(yx)yyxxyxx = xyyyx(xy)yyxxyxx
xyyyxyyxx(yx)xyx = xyyyxyyxx(xy)xyx
xyyyyxxx(yx)xyxy = xyyyyxxx(xy)xyxy
xyyyyxxx(yx)xyyx = xyyyyxxx(xy)xyyx
xyyyyxxx(yx)yxxy = xyyyyxxx(xy)yxxy
xyyyyxx(yxx)xyyx = xyyyyxx(xxy)xyyx
xyyyyxx(yx)xxyyx = xyyyyxx(xy)xxyyx
xyyyyxx(yxx)yxxy = xyyyyxx(xxy)yxxy
xyyyyxx(yx)xyxxy = xyyyyxx(xy)xyxxy
xyyyyxx(yx)xyxyx = xyyyyxx(xy)xyxyx
xyyyyxx(yx)xyyxx = xyyyyxx(xy)xyyxx
xyyyyxx(yx)yxxxy = xyyyyxx(xy)yxxxy
xyyyyxx(yx)yxxyx = xyyyyxx(xy)yxxyx
xyyyyxyxx(yx)xyx = xyyyyxyxx(xy)xyx
xyyyyx(yx)xyyxxx = xyyyyx(xy)xyyxxx
xyyyyx(yx)yxxxxy = xyyyyx(xy)yxxxxy
xyyyyx(yx)yxxxyx = xyyyyx(xy)yxxxyx
xyyyyx(yx)yxxyxx = xyyyyx(xy)yxxyxx
xyyyyx(yx)yxyxxx = xyyyyx(xy)yxyxxx
xyyyyyxxx(yx)xyx = xyyyyyxxx(xy)xyx
xyyyyyxx(yx)xyxx = xyyyyyxx(xy)xyxx
