# triangular relations for n = 11
#  relations (4,7)
xyyyyx(xy)yxy = xyyyyx(yx)yxy
xyyyyx(yx)yxy = xyyyyx(xy)yxy
#  relations (5,6)
xyyx(xy)xyyxy = xyyx(yx)xyyxy
xyyx(xy)xyyyx = xyyx(yx)xyyyx
xyyx(xy)yxxyy = xyyx(yx)yxxyy
xyyx(yx)xyyxy = xyyx(xy)xyyxy
xyyx(yx)xyyyx = xyyx(xy)xyyyx
xyyx(yx)yxxyy = xyyx(xy)yxxyy
xyyyx(xy)xyyx = xyyyx(yx)xyyx
xyyyx(xy)yxxy = xyyyx(yx)yxxy
xyyyx(yx)xyyx = xyyyx(xy)xyyx
xyyyx(yx)yxxy = xyyyx(xy)yxxy
#  relations (6,5)
xxyyx(xy)xyyx = xxyyx(yx)xyyx
xxyyx(xy)yxxy = xxyyx(yx)yxxy
xxyyx(yx)xyyx = xxyyx(xy)xyyx
xxyyx(yx)yxxy = xxyyx(xy)yxxy
xyx(xy)xxyyyx = xyx(yx)xxyyyx
xyxxy(xy)xyyx = xyxxy(yx)xyyx
xyxxy(xy)yxxy = xyxxy(yx)yxxy
xyxxy(yx)xyyx = xyxxy(xy)xyyx
xyxxy(yx)yxxy = xyxxy(xy)yxxy
xyx(yx)xxyyyx = xyx(xy)xxyyyx
xyyx(xy)xyyxx = xyyx(yx)xyyxx
xyyx(xy)yxxxy = xyyx(yx)yxxxy
xyyx(xy)yxxyx = xyyx(yx)yxxyx
xyyx(yx)xyyxx = xyyx(xy)xyyxx
xyyx(yx)yxxxy = xyyx(xy)yxxxy
xyyx(yx)yxxyx = xyyx(xy)yxxyx
xyyyxx(xy)xyx = xyyyxx(yx)xyx
xyyyxx(yx)xyx = xyyyxx(xy)xyx
#  relations (7,4)
xyx(xy)yxxxxy = xyx(yx)yxxxxy
xyx(yx)yxxxxy = xyx(xy)yxxxxy
