# triangular relations for n = 15
#  relations (4,11)
xyyyyx(yx)yxyyyyy = xyyyyx(xy)yxyyyyy
xyyyyyx(yx)yxyyyy = xyyyyyx(xy)yxyyyy
xyyyyyxy(yx)yyxyy = xyyyyyxy(xy)yyxyy
xyyyyyyx(yx)yxyyy = xyyyyyyx(xy)yxyyy
xyyyyyyx(yx)yyxyy = xyyyyyyx(xy)yyxyy
xyyyyyyxy(yx)yyxy = xyyyyyyxy(xy)yyxy
xyyyyyyyx(yx)yxyy = xyyyyyyyx(xy)yxyy
xyyyyyyyx(yx)yyxy = xyyyyyyyx(xy)yyxy
xyyyyyyyyx(yx)yxy = xyyyyyyyyx(xy)yxy
#  relations (5,10)
xxyyyyx(yx)yxyyyy = xxyyyyx(xy)yxyyyy
xxyyyyyx(yx)yxyyy = xxyyyyyx(xy)yxyyy
xxyyyyyxy(yx)yyxy = xxyyyyyxy(xy)yyxy
xxyyyyyyx(yx)yxyy = xxyyyyyyx(xy)yxyy
xxyyyyyyx(yx)yyxy = xxyyyyyyx(xy)yyxy
xxyyyyyyyx(yx)yxy = xxyyyyyyyx(xy)yxy
xyxxyyy(yx)yyxyyy = xyxxyyy(xy)yyxyyy
xyxxyyyy(yx)yyyxy = xyxxyyyy(xy)yyyxy
xyxy(yx)xyyyxyyyy = xyxy(xy)xyyyxyyyy
xyxy(yx)xyyyyxyyy = xyxy(xy)xyyyyxyyy
xyxy(yx)xyyyyyxyy = xyxy(xy)xyyyyyxyy
xyxy(yx)xyyyyyyxy = xyxy(xy)xyyyyyyxy
xyxy(yx)xyyyyyyyx = xyxy(xy)xyyyyyyyx
xyxyy(yx)xyyyyyyx = xyxyy(xy)xyyyyyyx
xyxyy(yx)yxyyyyyx = xyxyy(xy)yxyyyyyx
xyxyy(yx)yyyxxyyy = xyxyy(xy)yyyxxyyy
xyxyyyyx(yx)yxyyy = xyxyyyyx(xy)yxyyy
xyxyyy(yx)yyyyxxy = xyxyyy(xy)yyyyxxy
xyxyyyyyx(yx)yxyy = xyxyyyyyx(xy)yxyy
xyxyyyyyyx(yx)yxy = xyxyyyyyyx(xy)yxy
xyyxxyyy(yx)yyxyy = xyyxxyyy(xy)yyxyy
xyyx(yx)xyyxyyyyy = xyyx(xy)xyyxyyyyy
xyyx(yx)xyyyxyyyy = xyyx(xy)xyyyxyyyy
xyyx(yx)xyyyyxyyy = xyyx(xy)xyyyyxyyy
xyyx(yx)xyyyyyxyy = xyyx(xy)xyyyyyxyy
xyyx(yx)xyyyyyyxy = xyyx(xy)xyyyyyyxy
xyyx(yx)xyyyyyyyx = xyyx(xy)xyyyyyyyx
xyyx(yx)yxxyyyyyy = xyyx(xy)yxxyyyyyy
xyyxy(yx)xyyyyxyy = xyyxy(xy)xyyyyxyy
xyyxy(yx)xyyyyyxy = xyyxy(xy)xyyyyyxy
xyyxy(yx)xyyyyyyx = xyyxy(xy)xyyyyyyx
xyyxy(yx)yyxxyyyy = xyyxy(xy)yyxxyyyy
xyyxyy(yx)yyyxxyy = xyyxyy(xy)yyyxxyy
xyyxyyyyx(yx)yxyy = xyyxyyyyx(xy)yxyy
xyyxyyyyyx(yx)yxy = xyyxyyyyyx(xy)yxy
xyyyxxyyy(yx)yyxy = xyyyxxyyy(xy)yyxy
xyyyx(yx)xyyxyyyy = xyyyx(xy)xyyxyyyy
xyyyx(yx)xyyyxyyy = xyyyx(xy)xyyyxyyy
xyyyx(yx)xyyyyxyy = xyyyx(xy)xyyyyxyy
xyyyx(yx)xyyyyyxy = xyyyx(xy)xyyyyyxy
xyyyx(yx)xyyyyyyx = xyyyx(xy)xyyyyyyx
xyyyx(yx)yxxyyyyy = xyyyx(xy)yxxyyyyy
xyyyx(yx)yxyxyyyy = xyyyx(xy)yxyxyyyy
xyyyx(yx)yyxxyyyy = xyyyx(xy)yyxxyyyy
xyyyxy(yx)xyyyyxy = xyyyxy(xy)xyyyyxy
xyyyxy(yx)xyyyyyx = xyyyxy(xy)xyyyyyx
xyyyxy(yx)yxyyyxy = xyyyxy(xy)yxyyyxy
xyyyxy(yx)yxyyyyx = xyyyxy(xy)yxyyyyx
xyyyxy(yx)yyxxyyy = xyyyxy(xy)yyxxyyy
xyyyxy(yx)yyxyxyy = xyyyxy(xy)yyxyxyy
xyyyxy(yx)yyyxxyy = xyyyxy(xy)yyyxxyy
xyyyxyyyx(yx)yxyy = xyyyxyyyx(xy)yxyy
xyyyxyy(yx)yyyxxy = xyyyxyy(xy)yyyxxy
xyyyxyyyyx(yx)yxy = xyyyxyyyyx(xy)yxy
xyyyyx(yx)xyyxyyy = xyyyyx(xy)xyyxyyy
xyyyyx(yx)xyyyxyy = xyyyyx(xy)xyyyxyy
xyyyyx(yx)xyyyyxy = xyyyyx(xy)xyyyyxy
xyyyyx(yx)xyyyyyx = xyyyyx(xy)xyyyyyx
xyyyyx(yx)yxxyyyy = xyyyyx(xy)yxxyyyy
xyyyyx(yx)yxyxyyy = xyyyyx(xy)yxyxyyy
xyyyyx(yx)yxyyxyy = xyyyyx(xy)yxyyxyy
xyyyyx(yx)yxyyyxy = xyyyyx(xy)yxyyyxy
xyyyyx(yx)yxyyyyx = xyyyyx(xy)yxyyyyx
xyyyyx(yx)yyxxyyy = xyyyyx(xy)yyxxyyy
xyyyyx(yx)yyxyxyy = xyyyyx(xy)yyxyxyy
xyyyyx(yx)yyyxxyy = xyyyyx(xy)yyyxxyy
xyyyyx(yyx)xyyyyx = xyyyyx(xyy)xyyyyx
xyyyyxy(yx)xyyyyx = xyyyyxy(xy)xyyyyx
xyyyyxyyx(yx)yxyy = xyyyyxyyx(xy)yxyy
xyyyyxy(yx)yxyyyx = xyyyyxy(xy)yxyyyx
xyyyyx(yyx)yyxxyy = xyyyyx(xyy)yyxxyy
xyyyyxy(yx)yyxxyy = xyyyyxy(xy)yyxxyy
xyyyyxy(yx)yyxyxy = xyyyyxy(xy)yyxyxy
xyyyyxy(yx)yyyxxy = xyyyyxy(xy)yyyxxy
xyyyyxyyyx(yx)yxy = xyyyyxyyyx(xy)yxy
xyyyyyxxy(yx)yxyy = xyyyyyxxy(xy)yxyy
xyyyyyx(yx)xyyxyy = xyyyyyx(xy)xyyxyy
xyyyyyx(yxxy)yxyy = xyyyyyx(xyyx)yxyy
xyyyyyx(yx)xyyyxy = xyyyyyx(xy)xyyyxy
xyyyyyx(yx)xyyyyx = xyyyyyx(xy)xyyyyx
xyyyyyx(yx)yxxyyy = xyyyyyx(xy)yxxyyy
xyyyyyx(yxyx)yxyy = xyyyyyx(xyxy)yxyy
xyyyyyx(yx)yxyxyy = xyyyyyx(xy)yxyxyy
xyyyyyxyx(yx)yxyy = xyyyyyxyx(xy)yxyy
xyyyyyx(yx)yxyyxy = xyyyyyx(xy)yxyyxy
xyyyyyx(yx)yxyyyx = xyyyyyx(xy)yxyyyx
xyyyyyx(yx)yyxxyy = xyyyyyx(xy)yyxxyy
xyyyyyx(yx)yyxyxy = xyyyyyx(xy)yyxyxy
xyyyyyx(yx)yyyxxy = xyyyyyx(xy)yyyxxy
xyyyyyxyyx(yx)yxy = xyyyyyxyyx(xy)yxy
xyyyyyx(yyx)yyxxy = xyyyyyx(xyy)yyxxy
xyyyyyxy(yx)yyxxy = xyyyyyxy(xy)yyxxy
xyyyyyxy(yx)yyxyx = xyyyyyxy(xy)yyxyx
xyyyyyyxx(yx)yxyy = xyyyyyyxx(xy)yxyy
xyyyyyyxxy(yx)yxy = xyyyyyyxxy(xy)yxy
xyyyyyyx(yx)xyyxy = xyyyyyyx(xy)xyyxy
xyyyyyyx(yxxy)yxy = xyyyyyyx(xyyx)yxy
xyyyyyyx(yx)xyyyx = xyyyyyyx(xy)xyyyx
xyyyyyyx(yx)yxxyy = xyyyyyyx(xy)yxxyy
xyyyyyyx(yxyx)yxy = xyyyyyyx(xyxy)yxy
xyyyyyyx(yx)yxyxy = xyyyyyyx(xy)yxyxy
xyyyyyyxyx(yx)yxy = xyyyyyyxyx(xy)yxy
xyyyyyyx(yx)yxyyx = xyyyyyyx(xy)yxyyx
xyyyyyyx(yx)yyxxy = xyyyyyyx(xy)yyxxy
xyyyyyyx(yx)yyxyx = xyyyyyyx(xy)yyxyx
xyyyyyyyxx(yx)yxy = xyyyyyyyxx(xy)yxy
xyyyyyyyx(yx)xyyx = xyyyyyyyx(xy)xyyx
xyyyyyyyx(yx)yxxy = xyyyyyyyx(xy)yxxy
xyyyyyyyx(yx)yxyx = xyyyyyyyx(xy)yxyx
#  relations (6,9)
xxxyyyyx(yx)yxyyy = xxxyyyyx(xy)yxyyy
xxxyyyyyx(yx)yxyy = xxxyyyyyx(xy)yxyy
xxxyyyyyyx(yx)yxy = xxxyyyyyyx(xy)yxy
xxyxxyy(yx)yxyyyy = xxyxxyy(xy)yxyyyy
xxyxxyyy(yx)yyxyy = xxyxxyyy(xy)yyxyy
xxyxy(yx)xyyxyyyy = xxyxy(xy)xyyxyyyy
xxyxy(yx)xyyyxyyy = xxyxy(xy)xyyyxyyy
xxyxy(yx)xyyyyxyy = xxyxy(xy)xyyyyxyy
xxyxy(yx)xyyyyyxy = xxyxy(xy)xyyyyyxy
xxyxy(yx)xyyyyyyx = xxyxy(xy)xyyyyyyx
xxyxy(yx)yxxyyyyy = xxyxy(xy)yxxyyyyy
xxyxyy(yx)yyyxxyy = xxyxyy(xy)yyyxxyy
xxyxyyyyx(yx)yxyy = xxyxyyyyx(xy)yxyy
xxyxyyyyyx(yx)yxy = xxyxyyyyyx(xy)yxy
xxyyxxyyy(yx)yyxy = xxyyxxyyy(xy)yyxy
xxyyx(yx)xyyxyyyy = xxyyx(xy)xyyxyyyy
xxyyx(yx)xyyyxyyy = xxyyx(xy)xyyyxyyy
xxyyx(yx)xyyyyxyy = xxyyx(xy)xyyyyxyy
xxyyx(yx)xyyyyyxy = xxyyx(xy)xyyyyyxy
xxyyx(yx)xyyyyyyx = xxyyx(xy)xyyyyyyx
xxyyx(yx)yxxyyyyy = xxyyx(xy)yxxyyyyy
xxyyxy(yx)xyyyyxy = xxyyxy(xy)xyyyyxy
xxyyxy(yx)xyyyyyx = xxyyxy(xy)xyyyyyx
xxyyxy(yx)yyxxyyy = xxyyxy(xy)yyxxyyy
xxyyxyy(yx)yyyxxy = xxyyxyy(xy)yyyxxy
xxyyxyyyyx(yx)yxy = xxyyxyyyyx(xy)yxy
xxyyyx(yx)xyyxyyy = xxyyyx(xy)xyyxyyy
xxyyyx(yx)xyyyxyy = xxyyyx(xy)xyyyxyy
xxyyyx(yx)xyyyyxy = xxyyyx(xy)xyyyyxy
xxyyyx(yx)xyyyyyx = xxyyyx(xy)xyyyyyx
xxyyyx(yx)yxxyyyy = xxyyyx(xy)yxxyyyy
xxyyyx(yx)yxyxyyy = xxyyyx(xy)yxyxyyy
xxyyyx(yx)yyxxyyy = xxyyyx(xy)yyxxyyy
xxyyyxy(yx)xyyyyx = xxyyyxy(xy)xyyyyx
xxyyyxy(yx)yxyyyx = xxyyyxy(xy)yxyyyx
xxyyyxy(yx)yyxxyy = xxyyyxy(xy)yyxxyy
xxyyyxy(yx)yyxyxy = xxyyyxy(xy)yyxyxy
xxyyyxy(yx)yyyxxy = xxyyyxy(xy)yyyxxy
xxyyyxyyyx(yx)yxy = xxyyyxyyyx(xy)yxy
xxyyyyx(yx)xyyxyy = xxyyyyx(xy)xyyxyy
xxyyyyx(yx)xyyyxy = xxyyyyx(xy)xyyyxy
xxyyyyx(yx)xyyyyx = xxyyyyx(xy)xyyyyx
xxyyyyx(yx)yxxyyy = xxyyyyx(xy)yxxyyy
xxyyyyx(yx)yxyxyy = xxyyyyx(xy)yxyxyy
xxyyyyx(yx)yxyyxy = xxyyyyx(xy)yxyyxy
xxyyyyx(yx)yxyyyx = xxyyyyx(xy)yxyyyx
xxyyyyx(yx)yyxxyy = xxyyyyx(xy)yyxxyy
xxyyyyx(yx)yyxyxy = xxyyyyx(xy)yyxyxy
xxyyyyx(yx)yyyxxy = xxyyyyx(xy)yyyxxy
xxyyyyxyyx(yx)yxy = xxyyyyxyyx(xy)yxy
xxyyyyx(yyx)yyxxy = xxyyyyx(xyy)yyxxy
xxyyyyxy(yx)yyxxy = xxyyyyxy(xy)yyxxy
xxyyyyyxxy(yx)yxy = xxyyyyyxxy(xy)yxy
xxyyyyyx(yx)xyyxy = xxyyyyyx(xy)xyyxy
xxyyyyyx(yxxy)yxy = xxyyyyyx(xyyx)yxy
xxyyyyyx(yx)xyyyx = xxyyyyyx(xy)xyyyx
xxyyyyyx(yx)yxxyy = xxyyyyyx(xy)yxxyy
xxyyyyyx(yxyx)yxy = xxyyyyyx(xyxy)yxy
xxyyyyyx(yx)yxyxy = xxyyyyyx(xy)yxyxy
xxyyyyyxyx(yx)yxy = xxyyyyyxyx(xy)yxy
xxyyyyyx(yx)yxyyx = xxyyyyyx(xy)yxyyx
xxyyyyyx(yx)yyxxy = xxyyyyyx(xy)yyxxy
xxyyyyyyxx(yx)yxy = xxyyyyyyxx(xy)yxy
xxyyyyyyx(yx)xyyx = xxyyyyyyx(xy)xyyx
xxyyyyyyx(yx)yxxy = xxyyyyyyx(xy)yxxy
xxyyyyyyx(yx)yxyx = xxyyyyyyx(xy)yxyx
xyxxxyy(yx)yxyyyy = xyxxxyy(xy)yxyyyy
xyxxxyyy(yx)yyxyy = xyxxxyyy(xy)yyxyy
xyxxxyyyy(yx)yyxy = xyxxxyyyy(xy)yyxy
xyxxyxyyy(yx)yyxy = xyxxyxyyy(xy)yyxy
xyxxy(yx)xyyxyyyy = xyxxy(xy)xyyxyyyy
xyxxy(yx)xyyyxyyy = xyxxy(xy)xyyyxyyy
xyxxy(yx)xyyyyxyy = xyxxy(xy)xyyyyxyy
xyxxy(yx)xyyyyyxy = xyxxy(xy)xyyyyyxy
xyxxy(yx)xyyyyyyx = xyxxy(xy)xyyyyyyx
xyxxy(yx)yxxyyyyy = xyxxy(xy)yxxyyyyy
xyxxyy(yx)xyyyxyy = xyxxyy(xy)xyyyxyy
xyxxyy(yx)xyyyyxy = xyxxyy(xy)xyyyyxy
xyxxyy(yx)xyyyyyx = xyxxyy(xy)xyyyyyx
xyxxyy(yx)yxyyxyy = xyxxyy(xy)yxyyxyy
xyxxyy(yx)yxyyyxy = xyxxyy(xy)yxyyyxy
xyxxyy(yx)yxyyyyx = xyxxyy(xy)yxyyyyx
xyxxyy(yx)yyxxyyy = xyxxyy(xy)yyxxyyy
xyxxyy(yx)yyxyxyy = xyxxyy(xy)yyxyxyy
xyxxyy(yx)yyyxxyy = xyxxyy(xy)yyyxxyy
xyxxyy(yyx)xyyyyx = xyxxyy(xyy)xyyyyx
xyxxyyy(yx)xyyyyx = xyxxyyy(xy)xyyyyx
xyxxyyyyx(yx)yxyy = xyxxyyyyx(xy)yxyy
xyxxyyy(yx)yxyyyx = xyxxyyy(xy)yxyyyx
xyxxyy(yyx)yyxxyy = xyxxyy(xyy)yyxxyy
xyxxyyy(yx)yyxxyy = xyxxyyy(xy)yyxxyy
xyxxyyy(yx)yyxyxy = xyxxyyy(xy)yyxyxy
xyxxyyy(yx)yyxyyx = xyxxyyy(xy)yyxyyx
xyxxyyy(yx)yyyxxy = xyxxyyy(xy)yyyxxy
xyxxyyyyyx(yx)yxy = xyxxyyyyyx(xy)yxy
xyx(yx)xxyyyxyyyy = xyx(xy)xxyyyxyyyy
xyx(yx)xxyyyyxyyy = xyx(xy)xxyyyyxyyy
xyx(yx)xxyyyyyxyy = xyx(xy)xxyyyyyxyy
xyx(yx)xxyyyyyyxy = xyx(xy)xxyyyyyyxy
xyx(yx)xxyyyyyyyx = xyx(xy)xxyyyyyyyx
xyxyxxyyy(yx)yyxy = xyxyxxyyy(xy)yyxy
xyxyxy(yx)xyyyxyy = xyxyxy(xy)xyyyxyy
xyxyxy(yx)xyyyyxy = xyxyxy(xy)xyyyyxy
xyxyxy(yx)xyyyyyx = xyxyxy(xy)xyyyyyx
xyxyxyy(yx)xyyyyx = xyxyxyy(xy)xyyyyx
xyxyxyy(yx)yxyyyx = xyxyxyy(xy)yxyyyx
xyxyxyy(yx)yyxxyy = xyxyxyy(xy)yyxxyy
xyxyxyy(yx)yyxyxy = xyxyxyy(xy)yyxyxy
xyxyxyy(yx)yyyxxy = xyxyxyy(xy)yyyxxy
xyxyxyyyyx(yx)yxy = xyxyxyyyyx(xy)yxy
xyxy(yx)xxyyyyyyx = xyxy(xy)xxyyyyyyx
xyxy(yx)xyxyyyyyx = xyxy(xy)xyxyyyyyx
xyxy(yxxy)xyyyyyx = xyxy(xyyx)xyyyyyx
xyxy(yx)xyyxyyyyx = xyxy(xy)xyyxyyyyx
xyxy(yx)xyyyxyyyx = xyxy(xy)xyyyxyyyx
xyxy(yx)xyyyyxxyy = xyxy(xy)xyyyyxxyy
xyxy(yx)xyyyyxyxy = xyxy(xy)xyyyyxyxy
xyxy(yx)xyyyyxyyx = xyxy(xy)xyyyyxyyx
xyxy(yx)xyyyyyxxy = xyxy(xy)xyyyyyxxy
xyxy(yx)xyyyyyxyx = xyxy(xy)xyyyyyxyx
xyxy(yx)xyyyyyyxx = xyxy(xy)xyyyyyyxx
xyxyyx(yx)xyyxyyy = xyxyyx(xy)xyyxyyy
xyxyyx(yx)xyyyxyy = xyxyyx(xy)xyyyxyy
xyxyyx(yx)xyyyyxy = xyxyyx(xy)xyyyyxy
xyxy(yxyx)xyyyyyx = xyxy(xyxy)xyyyyyx
xyxy(yx)yxxyyyyyx = xyxy(xy)yxxyyyyyx
xyxyyx(yx)xyyyyyx = xyxyyx(xy)xyyyyyx
xyxyyx(yx)yxxyyyy = xyxyyx(xy)yxxyyyy
xyxy(yx)yyxxxyyyy = xyxy(xy)yyxxxyyyy
xyxyyxy(yx)xyyyyx = xyxyyxy(xy)xyyyyx
xyxyyxy(yx)yyxxyy = xyxyyxy(xy)yyxxyy
xyxyyyx(yx)xyyxyy = xyxyyyx(xy)xyyxyy
xyxyyyx(yx)xyyyxy = xyxyyyx(xy)xyyyxy
xyxyyyx(yx)xyyyyx = xyxyyyx(xy)xyyyyx
xyxyyyx(yx)yxxyyy = xyxyyyx(xy)yxxyyy
xyxyyyx(yx)yxyxyy = xyxyyyx(xy)yxyxyy
xyxyyyx(yx)yyxxyy = xyxyyyx(xy)yyxxyy
xyxyyyxy(yx)yyxxy = xyxyyyxy(xy)yyxxy
xyxyy(yx)yyyxxxyy = xyxyy(xy)yyyxxxyy
xyxyy(yx)yyyxxyxy = xyxyy(xy)yyyxxyxy
xyxyy(yx)yyyxxyyx = xyxyy(xy)yyyxxyyx
xyxyy(yx)yyyxyxxy = xyxyy(xy)yyyxyxxy
xyxyy(yx)yyyyxxxy = xyxyy(xy)yyyyxxxy
xyxyyyyx(yx)xyyxy = xyxyyyyx(xy)xyyxy
xyxyyyyx(yx)xyyyx = xyxyyyyx(xy)xyyyx
xyxyyyyx(yx)yxxyy = xyxyyyyx(xy)yxxyy
xyxyyyyx(yx)yxyxy = xyxyyyyx(xy)yxyxy
xyxyyyyx(yx)yxyyx = xyxyyyyx(xy)yxyyx
xyxyyyyx(yx)yyxxy = xyxyyyyx(xy)yyxxy
xyxyyyyyx(yx)xyyx = xyxyyyyyx(xy)xyyx
xyxyyyyyx(yx)yxxy = xyxyyyyyx(xy)yxxy
xyxyyyyyx(yx)yxyx = xyxyyyyyx(xy)yxyx
xyyxxxyy(yx)yxyyy = xyyxxxyy(xy)yxyyy
xyyxxxyyy(yx)yyxy = xyyxxxyyy(xy)yyxy
xyyxxy(yx)xyyxyyy = xyyxxy(xy)xyyxyyy
xyyxxy(yx)xyyyxyy = xyyxxy(xy)xyyyxyy
xyyxxy(yx)xyyyyxy = xyyxxy(xy)xyyyyxy
xyyxxy(yx)xyyyyyx = xyyxxy(xy)xyyyyyx
xyyxxy(yx)yxxyyyy = xyyxxy(xy)yxxyyyy
xyyxxyy(yx)xyyyxy = xyyxxyy(xy)xyyyxy
xyyxxyy(yx)xyyyyx = xyyxxyy(xy)xyyyyx
xyyxxyy(yx)yxyyxy = xyyxxyy(xy)yxyyxy
xyyxxyy(yx)yxyyyx = xyyxxyy(xy)yxyyyx
xyyxxyy(yx)yyxxyy = xyyxxyy(xy)yyxxyy
xyyxxyy(yx)yyxyxy = xyyxxyy(xy)yyxyxy
xyyxxyy(yx)yyyxxy = xyyxxyy(xy)yyyxxy
xyyxxyyyyx(yx)yxy = xyyxxyyyyx(xy)yxy
xyyxxyy(yyx)yyxxy = xyyxxyy(xyy)yyxxy
xyyxxyyy(yx)yyxxy = xyyxxyyy(xy)yyxxy
xyyxxyyy(yx)yyxyx = xyyxxyyy(xy)yyxyx
xyyx(yx)xxyyyxyyy = xyyx(xy)xxyyyxyyy
xyyx(yx)xxyyyyxyy = xyyx(xy)xxyyyyxyy
xyyx(yx)xxyyyyyxy = xyyx(xy)xxyyyyyxy
xyyx(yx)xxyyyyyyx = xyyx(xy)xxyyyyyyx
xyyx(yx)xyxyyxyyy = xyyx(xy)xyxyyxyyy
xyyx(yxxy)xyyxyyy = xyyx(xyyx)xyyxyyy
xyyx(yx)xyxyyyxyy = xyyx(xy)xyxyyyxyy
xyyx(yxxy)xyyyxyy = xyyx(xyyx)xyyyxyy
xyyx(yx)xyxyyyyxy = xyyx(xy)xyxyyyyxy
xyyx(yxxy)xyyyyxy = xyyx(xyyx)xyyyyxy
xyyx(yx)xyxyyyyyx = xyyx(xy)xyxyyyyyx
xyyx(yxxy)xyyyyyx = xyyx(xyyx)xyyyyyx
xyyx(yx)xyyxxyyyy = xyyx(xy)xyyxxyyyy
xyyx(yxxy)yxxyyyy = xyyx(xyyx)yxxyyyy
xyyx(yx)xyyxyxyyy = xyyx(xy)xyyxyxyyy
xyyx(yx)xyyxyyxyy = xyyx(xy)xyyxyyxyy
xyyx(yx)xyyxyyyxy = xyyx(xy)xyyxyyyxy
xyyx(yx)xyyxyyyyx = xyyx(xy)xyyxyyyyx
xyyx(yx)xyyyxxyyy = xyyx(xy)xyyyxxyyy
xyyx(yx)xyyyxyxyy = xyyx(xy)xyyyxyxyy
xyyx(yx)xyyyxyyxy = xyyx(xy)xyyyxyyxy
xyyx(yx)xyyyxyyyx = xyyx(xy)xyyyxyyyx
xyyx(yx)xyyyyxxyy = xyyx(xy)xyyyyxxyy
xyyx(yx)xyyyyxyxy = xyyx(xy)xyyyyxyxy
xyyx(yx)xyyyyxyyx = xyyx(xy)xyyyyxyyx
xyyx(yx)xyyyyyxxy = xyyx(xy)xyyyyyxxy
xyyx(yx)xyyyyyxyx = xyyx(xy)xyyyyyxyx
xyyx(yx)xyyyyyyxx = xyyx(xy)xyyyyyyxx
xyyx(yx)yxxxyyyyy = xyyx(xy)yxxxyyyyy
xyyx(yx)yxxyxyyyy = xyyx(xy)yxxyxyyyy
xyyx(yxyx)xyyxyyy = xyyx(xyxy)xyyxyyy
xyyx(yx)yxxyyxyyy = xyyx(xy)yxxyyxyyy
xyyxyx(yx)xyyxyyy = xyyxyx(xy)xyyxyyy
xyyx(yxyx)xyyyxyy = xyyx(xyxy)xyyyxyy
xyyx(yx)yxxyyyxyy = xyyx(xy)yxxyyyxyy
xyyxyx(yx)xyyyxyy = xyyxyx(xy)xyyyxyy
xyyx(yxyx)xyyyyxy = xyyx(xyxy)xyyyyxy
xyyx(yx)yxxyyyyxy = xyyx(xy)yxxyyyyxy
xyyxyx(yx)xyyyyxy = xyyxyx(xy)xyyyyxy
xyyx(yxyx)xyyyyyx = xyyx(xyxy)xyyyyyx
xyyx(yx)yxxyyyyyx = xyyx(xy)yxxyyyyyx
xyyxyx(yx)xyyyyyx = xyyxyx(xy)xyyyyyx
xyyx(yxyx)yxxyyyy = xyyx(xyxy)yxxyyyy
xyyx(yx)yxyxxyyyy = xyyx(xy)yxyxxyyyy
xyyxyx(yx)yxxyyyy = xyyxyx(xy)yxxyyyy
xyyx(yx)yyxxxyyyy = xyyx(xy)yyxxxyyyy
xyyxyxy(yx)xyyyxy = xyyxyxy(xy)xyyyxy
xyyxyxy(yx)xyyyyx = xyyxyxy(xy)xyyyyx
xyyxyxyy(yx)yyxxy = xyyxyxyy(xy)yyxxy
xyyxy(yx)xyyyyxxy = xyyxy(xy)xyyyyxxy
xyyxy(yx)xyyyyxyx = xyyxy(xy)xyyyyxyx
xyyxy(yx)xyyyyyxx = xyyxy(xy)xyyyyyxx
xyyxyyx(yx)xyyxyy = xyyxyyx(xy)xyyxyy
xyyxyyx(yx)xyyyxy = xyyxyyx(xy)xyyyxy
xyyxyyx(yx)xyyyyx = xyyxyyx(xy)xyyyyx
xyyxyyx(yx)yxxyyy = xyyxyyx(xy)yxxyyy
xyyxy(yx)yyxxxyyy = xyyxy(xy)yyxxxyyy
xyyxy(yx)yyxxyxyy = xyyxy(xy)yyxxyxyy
xyyxy(yx)yyxxyyxy = xyyxy(xy)yyxxyyxy
xyyxy(yx)yyxxyyyx = xyyxy(xy)yyxxyyyx
xyyxy(yx)yyxyxxyy = xyyxy(xy)yyxyxxyy
xyyxyyxy(yx)yyxxy = xyyxyyxy(xy)yyxxy
xyyxy(yx)yyyxxxyy = xyyxy(xy)yyyxxxyy
xyyxyyyx(yx)xyyxy = xyyxyyyx(xy)xyyxy
xyyxyyyx(yx)xyyyx = xyyxyyyx(xy)xyyyx
xyyxyyyx(yx)yxxyy = xyyxyyyx(xy)yxxyy
xyyxyyyx(yx)yxyxy = xyyxyyyx(xy)yxyxy
xyyxyyyx(yx)yyxxy = xyyxyyyx(xy)yyxxy
xyyxyy(yx)yyyxxxy = xyyxyy(xy)yyyxxxy
xyyxyy(yx)yyyxxyx = xyyxyy(xy)yyyxxyx
xyyxyyyyx(yx)xyyx = xyyxyyyyx(xy)xyyx
xyyxyyyyx(yx)yxxy = xyyxyyyyx(xy)yxxy
xyyxyyyyx(yx)yxyx = xyyxyyyyx(xy)yxyx
xyyyxxxyy(yx)yxyy = xyyyxxxyy(xy)yxyy
xyyyxx(yx)xyxyyyy = xyyyxx(xy)xyxyyyy
xyyyxx(yx)xyyxyyy = xyyyxx(xy)xyyxyyy
xyyyxx(yx)xyyyxyy = xyyyxx(xy)xyyyxyy
xyyyxx(yx)xyyyyxy = xyyyxx(xy)xyyyyxy
xyyyxx(yx)xyyyyyx = xyyyxx(xy)xyyyyyx
xyyyxx(yx)yxxyyyy = xyyyxx(xy)yxxyyyy
xyyyxxy(yx)xyyxyy = xyyyxxy(xy)xyyxyy
xyyyxxy(yx)xyyyxy = xyyyxxy(xy)xyyyxy
xyyyxxy(yx)xyyyyx = xyyyxxy(xy)xyyyyx
xyyyxxy(yx)yxxyyy = xyyyxxy(xy)yxxyyy
xyyyxxyy(yx)xyyyx = xyyyxxyy(xy)xyyyx
xyyyxxyy(yx)yxyyx = xyyyxxyy(xy)yxyyx
xyyyxxyy(yx)yyxxy = xyyyxxyy(xy)yyxxy
xyyyx(yxx)xyyyxyy = xyyyx(xxy)xyyyxyy
xyyyx(yx)xxyyyxyy = xyyyx(xy)xxyyyxyy
xyyyx(yxx)xyyyyxy = xyyyx(xxy)xyyyyxy
xyyyx(yx)xxyyyyxy = xyyyx(xy)xxyyyyxy
xyyyx(yxx)xyyyyyx = xyyyx(xxy)xyyyyyx
xyyyx(yx)xxyyyyyx = xyyyx(xy)xxyyyyyx
xyyyx(yx)xyxyyxyy = xyyyx(xy)xyxyyxyy
xyyyx(yxxy)xyyxyy = xyyyx(xyyx)xyyxyy
xyyyx(yx)xyxyyyxy = xyyyx(xy)xyxyyyxy
xyyyx(yxxy)xyyyxy = xyyyx(xyyx)xyyyxy
xyyyx(yx)xyxyyyyx = xyyyx(xy)xyxyyyyx
xyyyx(yxxy)xyyyyx = xyyyx(xyyx)xyyyyx
xyyyx(yx)xyyxxyyy = xyyyx(xy)xyyxxyyy
xyyyx(yxxy)yxxyyy = xyyyx(xyyx)yxxyyy
xyyyx(yx)xyyxyxyy = xyyyx(xy)xyyxyxyy
xyyyx(yx)xyyxyyxy = xyyyx(xy)xyyxyyxy
xyyyx(yx)xyyxyyyx = xyyyx(xy)xyyxyyyx
xyyyx(yx)xyyyxxyy = xyyyx(xy)xyyyxxyy
xyyyx(yx)xyyyxyxy = xyyyx(xy)xyyyxyxy
xyyyx(yx)xyyyxyyx = xyyyx(xy)xyyyxyyx
xyyyx(yx)xyyyyxxy = xyyyx(xy)xyyyyxxy
xyyyx(yx)xyyyyxyx = xyyyx(xy)xyyyyxyx
xyyyx(yx)xyyyyyxx = xyyyx(xy)xyyyyyxx
xyyyx(yx)yxxxyyyy = xyyyx(xy)yxxxyyyy
xyyyx(yx)yxxyxyyy = xyyyx(xy)yxxyxyyy
xyyyx(yxyx)xyyxyy = xyyyx(xyxy)xyyxyy
xyyyx(yx)yxxyyxyy = xyyyx(xy)yxxyyxyy
xyyyxyx(yx)xyyxyy = xyyyxyx(xy)xyyxyy
xyyyx(yxyx)xyyyxy = xyyyx(xyxy)xyyyxy
xyyyx(yx)yxxyyyxy = xyyyx(xy)yxxyyyxy
xyyyxyx(yx)xyyyxy = xyyyxyx(xy)xyyyxy
xyyyx(yxyx)xyyyyx = xyyyx(xyxy)xyyyyx
xyyyx(yx)yxxyyyyx = xyyyx(xy)yxxyyyyx
xyyyxyx(yx)xyyyyx = xyyyxyx(xy)xyyyyx
xyyyx(yxyx)yxxyyy = xyyyx(xyxy)yxxyyy
xyyyx(yx)yxyxxyyy = xyyyx(xy)yxyxxyyy
xyyyxyx(yx)yxxyyy = xyyyxyx(xy)yxxyyy
xyyyx(yx)yxyxyxyy = xyyyx(xy)yxyxyxyy
xyyyx(yx)yxyxyyxy = xyyyx(xy)yxyxyyxy
xyyyx(yx)yxyxyyyx = xyyyx(xy)yxyxyyyx
xyyyx(yxyxy)xyyyx = xyyyx(xyyyx)xyyyx
xyyyx(yx)yxyyxxyy = xyyyx(xy)yxyyxxyy
xyyyx(yx)yyxxxyyy = xyyyx(xy)yyxxxyyy
xyyyx(yx)yyxxyxyy = xyyyx(xy)yyxxyxyy
xyyyx(yx)yyxxyyxy = xyyyx(xy)yyxxyyxy
xyyyx(yxyyx)xyyyx = xyyyx(xyyxy)xyyyx
xyyyx(yx)yyxxyyyx = xyyyx(xy)yyxxyyyx
xyyyxyxy(yx)xyyyx = xyyyxyxy(xy)xyyyx
xyyyx(yx)yyxyxxyy = xyyyx(xy)yyxyxxyy
xyyyxyxy(yx)yyxxy = xyyyxyxy(xy)yyxxy
xyyyx(yx)yyyxxxyy = xyyyx(xy)yyyxxxyy
xyyyxy(yx)xyyyyxx = xyyyxy(xy)xyyyyxx
xyyyxyyx(yx)xyyxy = xyyyxyyx(xy)xyyxy
xyyyxyyx(yx)xyyyx = xyyyxyyx(xy)xyyyx
xyyyxyyx(yx)yxxyy = xyyyxyyx(xy)yxxyy
xyyyxyyx(yx)yxyxy = xyyyxyyx(xy)yxyxy
xyyyxyyx(yx)yyxxy = xyyyxyyx(xy)yyxxy
xyyyxy(yx)yxyyyxx = xyyyxy(xy)yxyyyxx
xyyyx(yyx)yyxxxyy = xyyyx(xyy)yyxxxyy
xyyyxy(yx)yyxxxyy = xyyyxy(xy)yyxxxyy
xyyyxy(yx)yyxxyxy = xyyyxy(xy)yyxxyxy
xyyyxy(yx)yyxxyyx = xyyyxy(xy)yyxxyyx
xyyyxy(yx)yyxyxxy = xyyyxy(xy)yyxyxxy
xyyyxy(yx)yyxyxyx = xyyyxy(xy)yyxyxyx
xyyyxy(yx)yyyxxxy = xyyyxy(xy)yyyxxxy
xyyyxy(yx)yyyxxyx = xyyyxy(xy)yyyxxyx
xyyyxyyyx(yx)xyyx = xyyyxyyyx(xy)xyyx
xyyyxyyyx(yx)yxxy = xyyyxyyyx(xy)yxxy
xyyyxyyyx(yx)yxyx = xyyyxyyyx(xy)yxyx
xyyyyxxxyy(yx)yxy = xyyyyxxxyy(xy)yxy
xyyyyxx(yx)xyxyyy = xyyyyxx(xy)xyxyyy
xyyyyxx(yx)xyyxyy = xyyyyxx(xy)xyyxyy
xyyyyxx(yx)xyyyxy = xyyyyxx(xy)xyyyxy
xyyyyxx(yx)xyyyyx = xyyyyxx(xy)xyyyyx
xyyyyxx(yx)yxxyyy = xyyyyxx(xy)yxxyyy
xyyyyxxy(yx)xyyxy = xyyyyxxy(xy)xyyxy
xyyyyxxy(yx)xyyyx = xyyyyxxy(xy)xyyyx
xyyyyxxy(yx)yxxyy = xyyyyxxy(xy)yxxyy
xyyyyxxy(yx)yxyxy = xyyyyxxy(xy)yxyxy
xyyyyxxy(yx)yyxxy = xyyyyxxy(xy)yyxxy
xyyyyx(yxx)xyyyxy = xyyyyx(xxy)xyyyxy
xyyyyx(yx)xxyyyxy = xyyyyx(xy)xxyyyxy
xyyyyx(yxx)xyyyyx = xyyyyx(xxy)xyyyyx
xyyyyx(yx)xxyyyyx = xyyyyx(xy)xxyyyyx
xyyyyx(yx)xyxyyxy = xyyyyx(xy)xyxyyxy
xyyyyx(yxxy)xyyxy = xyyyyx(xyyx)xyyxy
xyyyyx(yx)xyxyyyx = xyyyyx(xy)xyxyyyx
xyyyyx(yxxy)xyyyx = xyyyyx(xyyx)xyyyx
xyyyyx(yx)xyyxxyy = xyyyyx(xy)xyyxxyy
xyyyyx(yxxy)yxxyy = xyyyyx(xyyx)yxxyy
xyyyyx(yx)xyyxyxy = xyyyyx(xy)xyyxyxy
xyyyyx(yxxy)yxyxy = xyyyyx(xyyx)yxyxy
xyyyyx(yx)xyyxyyx = xyyyyx(xy)xyyxyyx
xyyyyx(yx)xyyyxxy = xyyyyx(xy)xyyyxxy
xyyyyx(yxxy)yyxxy = xyyyyx(xyyx)yyxxy
xyyyyx(yx)xyyyxyx = xyyyyx(xy)xyyyxyx
xyyyyx(yx)xyyyyxx = xyyyyx(xy)xyyyyxx
xyyyyx(yx)yxxxyyy = xyyyyx(xy)yxxxyyy
xyyyyx(yx)yxxyxyy = xyyyyx(xy)yxxyxyy
xyyyyx(yxyx)xyyxy = xyyyyx(xyxy)xyyxy
xyyyyx(yx)yxxyyxy = xyyyyx(xy)yxxyyxy
xyyyyxyx(yx)xyyxy = xyyyyxyx(xy)xyyxy
xyyyyx(yxyx)xyyyx = xyyyyx(xyxy)xyyyx
xyyyyx(yx)yxxyyyx = xyyyyx(xy)yxxyyyx
xyyyyxyx(yx)xyyyx = xyyyyxyx(xy)xyyyx
xyyyyx(yxyx)yxxyy = xyyyyx(xyxy)yxxyy
xyyyyx(yx)yxyxxyy = xyyyyx(xy)yxyxxyy
xyyyyxyx(yx)yxxyy = xyyyyxyx(xy)yxxyy
xyyyyx(yxyx)yxyxy = xyyyyx(xyxy)yxyxy
xyyyyx(yx)yxyxyxy = xyyyyx(xy)yxyxyxy
xyyyyxyx(yx)yxyxy = xyyyyxyx(xy)yxyxy
xyyyyx(yx)yxyxyyx = xyyyyx(xy)yxyxyyx
xyyyyx(yxyx)yyxxy = xyyyyx(xyxy)yyxxy
xyyyyx(yx)yxyyxxy = xyyyyx(xy)yxyyxxy
xyyyyxyx(yx)yyxxy = xyyyyxyx(xy)yyxxy
xyyyyx(yx)yxyyxyx = xyyyyx(xy)yxyyxyx
xyyyyx(yx)yxyyyxx = xyyyyx(xy)yxyyyxx
xyyyyx(yx)yyxxxyy = xyyyyx(xy)yyxxxyy
xyyyyx(yx)yyxxyxy = xyyyyx(xy)yyxxyxy
xyyyyx(yx)yyxxyyx = xyyyyx(xy)yyxxyyx
xyyyyx(yx)yyxyxxy = xyyyyx(xy)yyxyxxy
xyyyyx(yx)yyxyxyx = xyyyyx(xy)yyxyxyx
xyyyyx(yx)yyyxxxy = xyyyyx(xy)yyyxxxy
xyyyyx(yx)yyyxxyx = xyyyyx(xy)yyyxxyx
xyyyyxyyx(yx)xyyx = xyyyyxyyx(xy)xyyx
xyyyyxyyx(yx)yxxy = xyyyyxyyx(xy)yxxy
xyyyyxyyx(yx)yxyx = xyyyyxyyx(xy)yxyx
xyyyyx(yyx)yyxxxy = xyyyyx(xyy)yyxxxy
xyyyyxy(yx)yyxxxy = xyyyyxy(xy)yyxxxy
xyyyyx(yyx)yyxxyx = xyyyyx(xyy)yyxxyx
xyyyyxy(yx)yyxxyx = xyyyyxy(xy)yyxxyx
xyyyyyxx(yx)xyxyy = xyyyyyxx(xy)xyxyy
xyyyyyxx(yx)xyyxy = xyyyyyxx(xy)xyyxy
xyyyyyxx(yx)xyyyx = xyyyyyxx(xy)xyyyx
xyyyyyxx(yx)yxxyy = xyyyyyxx(xy)yxxyy
xyyyyyxx(yx)yxyxy = xyyyyyxx(xy)yxyxy
xyyyyyxx(yx)yyxxy = xyyyyyxx(xy)yyxxy
xyyyyyxxy(yx)xyyx = xyyyyyxxy(xy)xyyx
xyyyyyxx(yyx)yxxy = xyyyyyxx(xyy)yxxy
xyyyyyxxy(yx)yxxy = xyyyyyxxy(xy)yxxy
xyyyyyxxy(yx)yxyx = xyyyyyxxy(xy)yxyx
xyyyyyx(yxx)xyyyx = xyyyyyx(xxy)xyyyx
xyyyyyx(yx)xxyyyx = xyyyyyx(xy)xxyyyx
xyyyyyx(yx)xyxyyx = xyyyyyx(xy)xyxyyx
xyyyyyx(yxxy)xyyx = xyyyyyx(xyyx)xyyx
xyyyyyx(yxx)yyxxy = xyyyyyx(xxy)yyxxy
xyyyyyx(yx)xyyxxy = xyyyyyx(xy)xyyxxy
xyyyyyx(yxxy)yxxy = xyyyyyx(xyyx)yxxy
xyyyyyx(yx)xyyxyx = xyyyyyx(xy)xyyxyx
xyyyyyx(yxxy)yxyx = xyyyyyx(xyyx)yxyx
xyyyyyx(yx)xyyyxx = xyyyyyx(xy)xyyyxx
xyyyyyx(yx)yxxxyy = xyyyyyx(xy)yxxxyy
xyyyyyx(yx)yxxyxy = xyyyyyx(xy)yxxyxy
xyyyyyx(yxyx)xyyx = xyyyyyx(xyxy)xyyx
xyyyyyx(yx)yxxyyx = xyyyyyx(xy)yxxyyx
xyyyyyxyx(yx)xyyx = xyyyyyxyx(xy)xyyx
xyyyyyx(yxyx)yxxy = xyyyyyx(xxyy)yxxy
xyyyyyx(yxyx)yxxy = xyyyyyx(xyxy)yxxy
xyyyyyx(yx)yxyxxy = xyyyyyx(xy)yxyxxy
xyyyyyxyx(yx)yxxy = xyyyyyxyx(xy)yxxy
xyyyyyx(yxyx)yxyx = xyyyyyx(xyxy)yxyx
xyyyyyx(yx)yxyxyx = xyyyyyx(xy)yxyxyx
xyyyyyxyx(yx)yxyx = xyyyyyxyx(xy)yxyx
xyyyyyx(yx)yxyyxx = xyyyyyx(xy)yxyyxx
xyyyyyx(yx)yyxxxy = xyyyyyx(xy)yyxxxy
xyyyyyx(yx)yyxxyx = xyyyyyx(xy)yyxxyx
xyyyyyyxx(yx)xyxy = xyyyyyyxx(xy)xyxy
xyyyyyyxx(yx)xyyx = xyyyyyyxx(xy)xyyx
xyyyyyyxx(yx)yxxy = xyyyyyyxx(xy)yxxy
xyyyyyyxx(yx)yxyx = xyyyyyyxx(xy)yxyx
xyyyyyyx(yx)xyyxx = xyyyyyyx(xy)xyyxx
xyyyyyyx(yx)yxxxy = xyyyyyyx(xy)yxxxy
xyyyyyyx(yx)yxxyx = xyyyyyyx(xy)yxxyx
xyyyyyyx(yx)yxyxx = xyyyyyyx(xy)yxyxx
xyyyyyyyxx(yx)xyx = xyyyyyyyxx(xy)xyx
#  relations (7,8)
xxxxyyyyx(yx)yxyy = xxxxyyyyx(xy)yxyy
xxxxyyyyyx(yx)yxy = xxxxyyyyyx(xy)yxy
xxxyxxyy(yx)yxyyy = xxxyxxyy(xy)yxyyy
xxxyxxyyy(yx)yyxy = xxxyxxyyy(xy)yyxy
xxxyxy(yx)xyyyyxy = xxxyxy(xy)xyyyyxy
xxxyxy(yx)xyyyyyx = xxxyxy(xy)xyyyyyx
xxxyxyy(yx)yyyxxy = xxxyxyy(xy)yyyxxy
xxxyxyyyyx(yx)yxy = xxxyxyyyyx(xy)yxy
xxxyyxxyy(yx)yxyy = xxxyyxxyy(xy)yxyy
xxxyyx(yx)xyyxyyy = xxxyyx(xy)xyyxyyy
xxxyyx(yx)xyyyxyy = xxxyyx(xy)xyyyxyy
xxxyyx(yx)xyyyyxy = xxxyyx(xy)xyyyyxy
xxxyyx(yx)xyyyyyx = xxxyyx(xy)xyyyyyx
xxxyyx(yx)yxxyyyy = xxxyyx(xy)yxxyyyy
xxxyyxy(yx)xyyyyx = xxxyyxy(xy)xyyyyx
xxxyyxy(yx)yyxxyy = xxxyyxy(xy)yyxxyy
xxxyyyx(yx)xyyxyy = xxxyyyx(xy)xyyxyy
xxxyyyx(yx)xyyyxy = xxxyyyx(xy)xyyyxy
xxxyyyx(yx)xyyyyx = xxxyyyx(xy)xyyyyx
xxxyyyx(yx)yxxyyy = xxxyyyx(xy)yxxyyy
xxxyyyx(yx)yxyxyy = xxxyyyx(xy)yxyxyy
xxxyyyx(yx)yyxxyy = xxxyyyx(xy)yyxxyy
xxxyyyxy(yx)yyxxy = xxxyyyxy(xy)yyxxy
xxxyyyyx(yx)xyyxy = xxxyyyyx(xy)xyyxy
xxxyyyyx(yx)xyyyx = xxxyyyyx(xy)xyyyx
xxxyyyyx(yx)yxxyy = xxxyyyyx(xy)yxxyy
xxxyyyyx(yx)yxyxy = xxxyyyyx(xy)yxyxy
xxxyyyyx(yx)yxyyx = xxxyyyyx(xy)yxyyx
xxxyyyyx(yx)yyxxy = xxxyyyyx(xy)yyxxy
xxxyyyyyx(yx)xyyx = xxxyyyyyx(xy)xyyx
xxxyyyyyx(yx)yxxy = xxxyyyyyx(xy)yxxy
xxxyyyyyx(yx)yxyx = xxxyyyyyx(xy)yxyx
xxyxxxyy(yx)yxyyy = xxyxxxyy(xy)yxyyy
xxyxxxyyy(yx)yxyy = xxyxxxyyy(xy)yxyy
xxyxxxyyy(yx)yyxy = xxyxxxyyy(xy)yyxy
xxyxxyxyy(yx)yxyy = xxyxxyxyy(xy)yxyy
xxyxxy(yx)xyyxyyy = xxyxxy(xy)xyyxyyy
xxyxxy(yx)xyyyxyy = xxyxxy(xy)xyyyxyy
xxyxxy(yx)xyyyyxy = xxyxxy(xy)xyyyyxy
xxyxxy(yx)xyyyyyx = xxyxxy(xy)xyyyyyx
xxyxxy(yx)yxxyyyy = xxyxxy(xy)yxxyyyy
xxyxxyy(yx)xyyyxy = xxyxxyy(xy)xyyyxy
xxyxxyy(yx)xyyyyx = xxyxxyy(xy)xyyyyx
xxyxxyy(yx)yxyyxy = xxyxxyy(xy)yxyyxy
xxyxxyy(yx)yxyyyx = xxyxxyy(xy)yxyyyx
xxyxxyy(yx)yyxxyy = xxyxxyy(xy)yyxxyy
xxyxxyy(yx)yyxyxy = xxyxxyy(xy)yyxyxy
xxyxxyy(yx)yyyxxy = xxyxxyy(xy)yyyxxy
xxyxxyyyyx(yx)yxy = xxyxxyyyyx(xy)yxy
xxyxxyy(yyx)yyxxy = xxyxxyy(xyy)yyxxy
xxyxxyyy(yx)yyxxy = xxyxxyyy(xy)yyxxy
xxyxxyyy(yx)yyxyx = xxyxxyyy(xy)yyxyx
xxyx(yx)xxyyxyyyy = xxyx(xy)xxyyxyyyy
xxyx(yx)xxyyyxyyy = xxyx(xy)xxyyyxyyy
xxyx(yx)xxyyyyxyy = xxyx(xy)xxyyyyxyy
xxyx(yx)xxyyyyyxy = xxyx(xy)xxyyyyyxy
xxyx(yx)xxyyyyyyx = xxyx(xy)xxyyyyyyx
xxyxyxxyy(yx)yxyy = xxyxyxxyy(xy)yxyy
xxyxyxy(yx)xyyyxy = xxyxyxy(xy)xyyyxy
xxyxyxy(yx)xyyyyx = xxyxyxy(xy)xyyyyx
xxyxyxyy(yx)yyxxy = xxyxyxyy(xy)yyxxy
xxyxy(yx)xyyyyxxy = xxyxy(xy)xyyyyxxy
xxyxy(yx)xyyyyxyx = xxyxy(xy)xyyyyxyx
xxyxy(yx)xyyyyyxx = xxyxy(xy)xyyyyyxx
xxyxyyx(yx)xyyxyy = xxyxyyx(xy)xyyxyy
xxyxyyx(yx)xyyyxy = xxyxyyx(xy)xyyyxy
xxyxyyx(yx)xyyyyx = xxyxyyx(xy)xyyyyx
xxyxyyx(yx)yxxyyy = xxyxyyx(xy)yxxyyy
xxyxy(yx)yyxxxyyy = xxyxy(xy)yyxxxyyy
xxyxyyxy(yx)yyxxy = xxyxyyxy(xy)yyxxy
xxyxyyyx(yx)xyyxy = xxyxyyyx(xy)xyyxy
xxyxyyyx(yx)xyyyx = xxyxyyyx(xy)xyyyx
xxyxyyyx(yx)yxxyy = xxyxyyyx(xy)yxxyy
xxyxyyyx(yx)yxyxy = xxyxyyyx(xy)yxyxy
xxyxyyyx(yx)yyxxy = xxyxyyyx(xy)yyxxy
xxyxyy(yx)yyyxxxy = xxyxyy(xy)yyyxxxy
xxyxyy(yx)yyyxxyx = xxyxyy(xy)yyyxxyx
xxyxyyyyx(yx)xyyx = xxyxyyyyx(xy)xyyx
xxyxyyyyx(yx)yxxy = xxyxyyyyx(xy)yxxy
xxyxyyyyx(yx)yxyx = xxyxyyyyx(xy)yxyx
xxyyxxxyy(yx)yxyy = xxyyxxxyy(xy)yxyy
xxyyxxy(yx)xyyxyy = xxyyxxy(xy)xyyxyy
xxyyxxy(yx)xyyyxy = xxyyxxy(xy)xyyyxy
xxyyxxy(yx)xyyyyx = xxyyxxy(xy)xyyyyx
xxyyxxy(yx)yxxyyy = xxyyxxy(xy)yxxyyy
xxyyxxyy(yx)xyyyx = xxyyxxyy(xy)xyyyx
xxyyxxyy(yx)yxyyx = xxyyxxyy(xy)yxyyx
xxyyxxyy(yx)yyxxy = xxyyxxyy(xy)yyxxy
xxyyx(yx)xxyyyxyy = xxyyx(xy)xxyyyxyy
xxyyx(yx)xxyyyyxy = xxyyx(xy)xxyyyyxy
xxyyx(yx)xxyyyyyx = xxyyx(xy)xxyyyyyx
xxyyx(yx)xyxyyxyy = xxyyx(xy)xyxyyxyy
xxyyx(yxxy)xyyxyy = xxyyx(xyyx)xyyxyy
xxyyx(yx)xyxyyyxy = xxyyx(xy)xyxyyyxy
xxyyx(yxxy)xyyyxy = xxyyx(xyyx)xyyyxy
xxyyx(yx)xyxyyyyx = xxyyx(xy)xyxyyyyx
xxyyx(yxxy)xyyyyx = xxyyx(xyyx)xyyyyx
xxyyx(yx)xyyxxyyy = xxyyx(xy)xyyxxyyy
xxyyx(yxxy)yxxyyy = xxyyx(xyyx)yxxyyy
xxyyx(yx)xyyxyxyy = xxyyx(xy)xyyxyxyy
xxyyx(yx)xyyxyyxy = xxyyx(xy)xyyxyyxy
xxyyx(yx)xyyxyyyx = xxyyx(xy)xyyxyyyx
xxyyx(yx)xyyyxxyy = xxyyx(xy)xyyyxxyy
xxyyx(yx)xyyyxyxy = xxyyx(xy)xyyyxyxy
xxyyx(yx)xyyyxyyx = xxyyx(xy)xyyyxyyx
xxyyx(yx)xyyyyxxy = xxyyx(xy)xyyyyxxy
xxyyx(yx)xyyyyxyx = xxyyx(xy)xyyyyxyx
xxyyx(yx)xyyyyyxx = xxyyx(xy)xyyyyyxx
xxyyx(yx)yxxxyyyy = xxyyx(xy)yxxxyyyy
xxyyx(yx)yxxyxyyy = xxyyx(xy)yxxyxyyy
xxyyx(yxyx)xyyxyy = xxyyx(xyxy)xyyxyy
xxyyx(yx)yxxyyxyy = xxyyx(xy)yxxyyxyy
xxyyxyx(yx)xyyxyy = xxyyxyx(xy)xyyxyy
xxyyx(yxyx)xyyyxy = xxyyx(xyxy)xyyyxy
xxyyx(yx)yxxyyyxy = xxyyx(xy)yxxyyyxy
xxyyxyx(yx)xyyyxy = xxyyxyx(xy)xyyyxy
xxyyx(yxyx)xyyyyx = xxyyx(xyxy)xyyyyx
xxyyx(yx)yxxyyyyx = xxyyx(xy)yxxyyyyx
xxyyxyx(yx)xyyyyx = xxyyxyx(xy)xyyyyx
xxyyx(yxyx)yxxyyy = xxyyx(xyxy)yxxyyy
xxyyx(yx)yxyxxyyy = xxyyx(xy)yxyxxyyy
xxyyxyx(yx)yxxyyy = xxyyxyx(xy)yxxyyy
xxyyx(yx)yyxxxyyy = xxyyx(xy)yyxxxyyy
xxyyxyxy(yx)xyyyx = xxyyxyxy(xy)xyyyx
xxyyxy(yx)xyyyyxx = xxyyxy(xy)xyyyyxx
xxyyxyyx(yx)xyyxy = xxyyxyyx(xy)xyyxy
xxyyxyyx(yx)xyyyx = xxyyxyyx(xy)xyyyx
xxyyxyyx(yx)yxxyy = xxyyxyyx(xy)yxxyy
xxyyxy(yx)yyxxxyy = xxyyxy(xy)yyxxxyy
xxyyxy(yx)yyxxyxy = xxyyxy(xy)yyxxyxy
xxyyxy(yx)yyxxyyx = xxyyxy(xy)yyxxyyx
xxyyxy(yx)yyxyxxy = xxyyxy(xy)yyxyxxy
xxyyxy(yx)yyyxxxy = xxyyxy(xy)yyyxxxy
xxyyxyyyx(yx)xyyx = xxyyxyyyx(xy)xyyx
xxyyxyyyx(yx)yxxy = xxyyxyyyx(xy)yxxy
xxyyyxxxyy(yx)yxy = xxyyyxxxyy(xy)yxy
xxyyyxx(yx)xyxyyy = xxyyyxx(xy)xyxyyy
xxyyyxx(yx)xyyxyy = xxyyyxx(xy)xyyxyy
xxyyyxx(yx)xyyyxy = xxyyyxx(xy)xyyyxy
xxyyyxx(yx)xyyyyx = xxyyyxx(xy)xyyyyx
xxyyyxx(yx)yxxyyy = xxyyyxx(xy)yxxyyy
xxyyyxxy(yx)xyyxy = xxyyyxxy(xy)xyyxy
xxyyyxxy(yx)xyyyx = xxyyyxxy(xy)xyyyx
xxyyyxxy(yx)yxxyy = xxyyyxxy(xy)yxxyy
xxyyyx(yxx)xyyyxy = xxyyyx(xxy)xyyyxy
xxyyyx(yx)xxyyyxy = xxyyyx(xy)xxyyyxy
xxyyyx(yxx)xyyyyx = xxyyyx(xxy)xyyyyx
xxyyyx(yx)xxyyyyx = xxyyyx(xy)xxyyyyx
xxyyyx(yx)xyxyyxy = xxyyyx(xy)xyxyyxy
xxyyyx(yxxy)xyyxy = xxyyyx(xyyx)xyyxy
xxyyyx(yx)xyxyyyx = xxyyyx(xy)xyxyyyx
xxyyyx(yxxy)xyyyx = xxyyyx(xyyx)xyyyx
xxyyyx(yx)xyyxxyy = xxyyyx(xy)xyyxxyy
xxyyyx(yxxy)yxxyy = xxyyyx(xyyx)yxxyy
xxyyyx(yx)xyyxyxy = xxyyyx(xy)xyyxyxy
xxyyyx(yx)xyyxyyx = xxyyyx(xy)xyyxyyx
xxyyyx(yx)xyyyxxy = xxyyyx(xy)xyyyxxy
xxyyyx(yx)xyyyxyx = xxyyyx(xy)xyyyxyx
xxyyyx(yx)xyyyyxx = xxyyyx(xy)xyyyyxx
xxyyyx(yx)yxxxyyy = xxyyyx(xy)yxxxyyy
xxyyyx(yx)yxxyxyy = xxyyyx(xy)yxxyxyy
xxyyyx(yxyx)xyyxy = xxyyyx(xyxy)xyyxy
xxyyyx(yx)yxxyyxy = xxyyyx(xy)yxxyyxy
xxyyyxyx(yx)xyyxy = xxyyyxyx(xy)xyyxy
xxyyyx(yxyx)xyyyx = xxyyyx(xyxy)xyyyx
xxyyyx(yx)yxxyyyx = xxyyyx(xy)yxxyyyx
xxyyyxyx(yx)xyyyx = xxyyyxyx(xy)xyyyx
xxyyyx(yxyx)yxxyy = xxyyyx(xyxy)yxxyy
xxyyyx(yx)yxyxxyy = xxyyyx(xy)yxyxxyy
xxyyyxyx(yx)yxxyy = xxyyyxyx(xy)yxxyy
xxyyyx(yx)yxyxyxy = xxyyyx(xy)yxyxyxy
xxyyyx(yx)yxyxyyx = xxyyyx(xy)yxyxyyx
xxyyyx(yx)yxyyxxy = xxyyyx(xy)yxyyxxy
xxyyyx(yx)yyxxxyy = xxyyyx(xy)yyxxxyy
xxyyyx(yx)yyxxyxy = xxyyyx(xy)yyxxyxy
xxyyyx(yx)yyxxyyx = xxyyyx(xy)yyxxyyx
xxyyyx(yx)yyxyxxy = xxyyyx(xy)yyxyxxy
xxyyyx(yx)yyyxxxy = xxyyyx(xy)yyyxxxy
xxyyyxyyx(yx)xyyx = xxyyyxyyx(xy)xyyx
xxyyyxyyx(yx)yxxy = xxyyyxyyx(xy)yxxy
xxyyyx(yyx)yyxxxy = xxyyyx(xyy)yyxxxy
xxyyyxy(yx)yyxxxy = xxyyyxy(xy)yyxxxy
xxyyyxy(yx)yyxxyx = xxyyyxy(xy)yyxxyx
xxyyyyxx(yx)xyxyy = xxyyyyxx(xy)xyxyy
xxyyyyxx(yx)xyyxy = xxyyyyxx(xy)xyyxy
xxyyyyxx(yx)xyyyx = xxyyyyxx(xy)xyyyx
xxyyyyxx(yx)yxxyy = xxyyyyxx(xy)yxxyy
xxyyyyxxy(yx)xyyx = xxyyyyxxy(xy)xyyx
xxyyyyxxy(yx)yxxy = xxyyyyxxy(xy)yxxy
xxyyyyx(yxx)xyyyx = xxyyyyx(xxy)xyyyx
xxyyyyx(yx)xxyyyx = xxyyyyx(xy)xxyyyx
xxyyyyx(yx)xyxyyx = xxyyyyx(xy)xyxyyx
xxyyyyx(yxxy)xyyx = xxyyyyx(xyyx)xyyx
xxyyyyx(yx)xyyxxy = xxyyyyx(xy)xyyxxy
xxyyyyx(yxxy)yxxy = xxyyyyx(xyyx)yxxy
xxyyyyx(yx)xyyxyx = xxyyyyx(xy)xyyxyx
xxyyyyx(yx)xyyyxx = xxyyyyx(xy)xyyyxx
xxyyyyx(yx)yxxxyy = xxyyyyx(xy)yxxxyy
xxyyyyx(yx)yxxyxy = xxyyyyx(xy)yxxyxy
xxyyyyx(yxyx)xyyx = xxyyyyx(xyxy)xyyx
xxyyyyx(yx)yxxyyx = xxyyyyx(xy)yxxyyx
xxyyyyxyx(yx)xyyx = xxyyyyxyx(xy)xyyx
xxyyyyx(yxyx)yxxy = xxyyyyx(xyxy)yxxy
xxyyyyx(yx)yxyxxy = xxyyyyx(xy)yxyxxy
xxyyyyxyx(yx)yxxy = xxyyyyxyx(xy)yxxy
xxyyyyx(yx)yxyxyx = xxyyyyx(xy)yxyxyx
xxyyyyx(yx)yxyyxx = xxyyyyx(xy)yxyyxx
xxyyyyx(yx)yyxxxy = xxyyyyx(xy)yyxxxy
xxyyyyx(yx)yyxxyx = xxyyyyx(xy)yyxxyx
xxyyyyyxx(yx)xyxy = xxyyyyyxx(xy)xyxy
xxyyyyyxx(yx)xyyx = xxyyyyyxx(xy)xyyx
xxyyyyyxx(yx)yxxy = xxyyyyyxx(xy)yxxy
xxyyyyyx(yx)xyyxx = xxyyyyyx(xy)xyyxx
xxyyyyyx(yx)yxxxy = xxyyyyyx(xy)yxxxy
xxyyyyyx(yx)yxxyx = xxyyyyyx(xy)yxxyx
xxyyyyyx(yx)yxyxx = xxyyyyyx(xy)yxyxx
xxyyyyyyxx(yx)xyx = xxyyyyyyxx(xy)xyx
xyxxxxyy(yx)yxyyy = xyxxxxyy(xy)yxyyy
xyxxxxyyy(yx)yxyy = xyxxxxyyy(xy)yxyy
xyxxxxyyy(yx)yyxy = xyxxxxyyy(xy)yyxy
xyxxxyxyy(yx)yxyy = xyxxxyxyy(xy)yxyy
xyxxxy(yx)xyyxyyy = xyxxxy(xy)xyyxyyy
xyxxxy(yx)xyyyxyy = xyxxxy(xy)xyyyxyy
xyxxxy(yx)xyyyyxy = xyxxxy(xy)xyyyyxy
xyxxxy(yx)xyyyyyx = xyxxxy(xy)xyyyyyx
xyxxxy(yx)yxxyyyy = xyxxxy(xy)yxxyyyy
xyxxxyy(yx)xyyxyy = xyxxxyy(xy)xyyxyy
xyxxxyy(yx)xyyyxy = xyxxxyy(xy)xyyyxy
xyxxxyy(yx)xyyyyx = xyxxxyy(xy)xyyyyx
xyxxxyy(yx)yxxyyy = xyxxxyy(xy)yxxyyy
xyxxxyy(yx)yxyxyy = xyxxxyy(xy)yxyxyy
xyxxxyy(yx)yxyyxy = xyxxxyy(xy)yxyyxy
xyxxxyy(yx)yxyyyx = xyxxxyy(xy)yxyyyx
xyxxxyy(yx)yyxxyy = xyxxxyy(xy)yyxxyy
xyxxxyy(yx)yyxyxy = xyxxxyy(xy)yyxyxy
xyxxxyy(yx)yyyxxy = xyxxxyy(xy)yyyxxy
xyxxxyy(yyx)xyyyx = xyxxxyy(xyy)xyyyx
xyxxxyyy(yx)xyyyx = xyxxxyyy(xy)xyyyx
xyxxxyyyyx(yx)yxy = xyxxxyyyyx(xy)yxy
xyxxxyyy(yx)yxyyx = xyxxxyyy(xy)yxyyx
xyxxxyy(yyx)yyxxy = xyxxxyy(xyy)yyxxy
xyxxxyyy(yx)yyxxy = xyxxxyyy(xy)yyxxy
xyxxxyyy(yx)yyxyx = xyxxxyyy(xy)yyxyx
xyxxyxxyy(yx)yxyy = xyxxyxxyy(xy)yxyy
xyxxyxy(yx)xyyxyy = xyxxyxy(xy)xyyxyy
xyxxyxy(yx)xyyyxy = xyxxyxy(xy)xyyyxy
xyxxyxy(yx)xyyyyx = xyxxyxy(xy)xyyyyx
xyxxyxy(yx)yxxyyy = xyxxyxy(xy)yxxyyy
xyxxyxyy(yx)xyyyx = xyxxyxyy(xy)xyyyx
xyxxyxyy(yx)yxyyx = xyxxyxyy(xy)yxyyx
xyxxyxyy(yx)yyxxy = xyxxyxyy(xy)yyxxy
xyxxy(yx)xxyyyxyy = xyxxy(xy)xxyyyxyy
xyxxy(yx)xxyyyyxy = xyxxy(xy)xxyyyyxy
xyxxy(yx)xxyyyyyx = xyxxy(xy)xxyyyyyx
xyxxy(yx)xyxyyxyy = xyxxy(xy)xyxyyxyy
xyxxy(yxxy)xyyxyy = xyxxy(xyyx)xyyxyy
xyxxy(yx)xyxyyyxy = xyxxy(xy)xyxyyyxy
xyxxy(yxxy)xyyyxy = xyxxy(xyyx)xyyyxy
xyxxy(yx)xyxyyyyx = xyxxy(xy)xyxyyyyx
xyxxy(yxxy)xyyyyx = xyxxy(xyyx)xyyyyx
xyxxy(yx)xyyxxyyy = xyxxy(xy)xyyxxyyy
xyxxy(yxxy)yxxyyy = xyxxy(xyyx)yxxyyy
xyxxy(yx)xyyxyxyy = xyxxy(xy)xyyxyxyy
xyxxy(yx)xyyxyyxy = xyxxy(xy)xyyxyyxy
xyxxy(yx)xyyxyyyx = xyxxy(xy)xyyxyyyx
xyxxy(yx)xyyyxxyy = xyxxy(xy)xyyyxxyy
xyxxy(yx)xyyyxyxy = xyxxy(xy)xyyyxyxy
xyxxy(yx)xyyyxyyx = xyxxy(xy)xyyyxyyx
xyxxy(yx)xyyyyxxy = xyxxy(xy)xyyyyxxy
xyxxy(yx)xyyyyxyx = xyxxy(xy)xyyyyxyx
xyxxy(yx)xyyyyyxx = xyxxy(xy)xyyyyyxx
xyxxy(yx)yxxxyyyy = xyxxy(xy)yxxxyyyy
xyxxy(yx)yxxyxyyy = xyxxy(xy)yxxyxyyy
xyxxy(yxyx)xyyxyy = xyxxy(xyxy)xyyxyy
xyxxy(yx)yxxyyxyy = xyxxy(xy)yxxyyxyy
xyxxyyx(yx)xyyxyy = xyxxyyx(xy)xyyxyy
xyxxy(yxyx)xyyyxy = xyxxy(xyxy)xyyyxy
xyxxy(yx)yxxyyyxy = xyxxy(xy)yxxyyyxy
xyxxyyx(yx)xyyyxy = xyxxyyx(xy)xyyyxy
xyxxy(yxyx)xyyyyx = xyxxy(xyxy)xyyyyx
xyxxy(yx)yxxyyyyx = xyxxy(xy)yxxyyyyx
xyxxyyx(yx)xyyyyx = xyxxyyx(xy)xyyyyx
xyxxy(yxyx)yxxyyy = xyxxy(xyxy)yxxyyy
xyxxy(yx)yxyxxyyy = xyxxy(xy)yxyxxyyy
xyxxyyx(yx)yxxyyy = xyxxyyx(xy)yxxyyy
xyxxy(yx)yyxxxyyy = xyxxy(xy)yyxxxyyy
xyxxyyxy(yx)xyyyx = xyxxyyxy(xy)xyyyx
xyxxyyxy(yx)yyxxy = xyxxyyxy(xy)yyxxy
xyxxyy(yx)xyyyxxy = xyxxyy(xy)xyyyxxy
xyxxyy(yxxy)yyxxy = xyxxyy(xyyx)yyxxy
xyxxyy(yx)xyyyxyx = xyxxyy(xy)xyyyxyx
xyxxyy(yx)xyyyyxx = xyxxyy(xy)xyyyyxx
xyxxyyyx(yx)xyyxy = xyxxyyyx(xy)xyyxy
xyxxyyyx(yx)xyyyx = xyxxyyyx(xy)xyyyx
xyxxyyyx(yx)yxxyy = xyxxyyyx(xy)yxxyy
xyxxyyyx(yx)yxyxy = xyxxyyyx(xy)yxyxy
xyxxyy(yxyx)yyxxy = xyxxyy(xyxy)yyxxy
xyxxyy(yx)yxyyxxy = xyxxyy(xy)yxyyxxy
xyxxyyyx(yx)yyxxy = xyxxyyyx(xy)yyxxy
xyxxyy(yx)yxyyxyx = xyxxyy(xy)yxyyxyx
xyxxyy(yx)yxyyyxx = xyxxyy(xy)yxyyyxx
xyxxyy(yx)yyxxxyy = xyxxyy(xy)yyxxxyy
xyxxyy(yx)yyxxyxy = xyxxyy(xy)yyxxyxy
xyxxyy(yx)yyxxyyx = xyxxyy(xy)yyxxyyx
xyxxyy(yx)yyxyxxy = xyxxyy(xy)yyxyxxy
xyxxyy(yx)yyxyxyx = xyxxyy(xy)yyxyxyx
xyxxyy(yx)yyyxxxy = xyxxyy(xy)yyyxxxy
xyxxyy(yx)yyyxxyx = xyxxyy(xy)yyyxxyx
xyxxyyyyx(yx)xyyx = xyxxyyyyx(xy)xyyx
xyxxyyyyx(yx)yxxy = xyxxyyyyx(xy)yxxy
xyxxyyyyx(yx)yxyx = xyxxyyyyx(xy)yxyx
xyxxyy(yyx)yyxxxy = xyxxyy(xyy)yyxxxy
xyxxyyy(yx)yyxxxy = xyxxyyy(xy)yyxxxy
xyxxyy(yyx)yyxxyx = xyxxyy(xyy)yyxxyx
xyxxyyy(yx)yyxxyx = xyxxyyy(xy)yyxxyx
xyxxyyy(yx)yyxyxx = xyxxyyy(xy)yyxyxx
xyx(yx)xxxyyyyxyy = xyx(xy)xxxyyyyxyy
xyx(yx)xxxyyyyyxy = xyx(xy)xxxyyyyyxy
xyx(yx)xxxyyyyyyx = xyx(xy)xxxyyyyyyx
xyx(yx)xxyxyyyxyy = xyx(xy)xxyxyyyxyy
xyx(yx)xxyxyyyyxy = xyx(xy)xxyxyyyyxy
xyx(yx)xxyxyyyyyx = xyx(xy)xxyxyyyyyx
xyx(yx)xxyyxyyxyy = xyx(xy)xxyyxyyxyy
xyx(yxxxyyxy)yxyy = xyx(xyxxyyyx)yxyy
xyx(yx)xxyyxyyyxy = xyx(xy)xxyyxyyyxy
xyx(yx)xxyyxyyyyx = xyx(xy)xxyyxyyyyx
xyx(yx)xxyyyxxyyy = xyx(xy)xxyyyxxyyy
xyx(yxxxyyyx)yxyy = xyx(xyxxyyxy)yxyy
xyx(yx)xxyyyxyxyy = xyx(xy)xxyyyxyxyy
xyxyxxxyy(yx)yxyy = xyxyxxxyy(xy)yxyy
xyx(yx)xxyyyxyyxy = xyx(xy)xxyyyxyyxy
xyx(yx)xxyyyxyyyx = xyx(xy)xxyyyxyyyx
xyx(yx)xxyyyyxxyy = xyx(xy)xxyyyyxxyy
xyx(yx)xxyyyyxyxy = xyx(xy)xxyyyyxyxy
xyx(yx)xxyyyyxyyx = xyx(xy)xxyyyyxyyx
xyx(yx)xxyyyyyxxy = xyx(xy)xxyyyyyxxy
xyx(yx)xxyyyyyxyx = xyx(xy)xxyyyyyxyx
xyx(yx)xxyyyyyyxx = xyx(xy)xxyyyyyyxx
xyxyxxy(yx)xyyxyy = xyxyxxy(xy)xyyxyy
xyxyxxy(yx)xyyyxy = xyxyxxy(xy)xyyyxy
xyxyxxy(yx)xyyyyx = xyxyxxy(xy)xyyyyx
xyxyxxy(yx)yxxyyy = xyxyxxy(xy)yxxyyy
xyxyxxyy(yx)xyyyx = xyxyxxyy(xy)xyyyx
xyxyxxyy(yx)yxyyx = xyxyxxyy(xy)yxyyx
xyxyxxyy(yx)yyxxy = xyxyxxyy(xy)yyxxy
xyx(yx)yxxxxyyyyy = xyx(xy)yxxxxyyyyy
xyxyx(yx)xxyyyxyy = xyxyx(xy)xxyyyxyy
xyxyx(yx)xxyyyyxy = xyxyx(xy)xxyyyyxy
xyxyx(yx)xxyyyyyx = xyxyx(xy)xxyyyyyx
xyxyx(yx)yxxxyyyy = xyxyx(xy)yxxxyyyy
xyxyxyxy(yx)xyyyx = xyxyxyxy(xy)xyyyx
xyxyxy(yx)xyyyxxy = xyxyxy(xy)xyyyxxy
xyxyxy(yx)xyyyxyx = xyxyxy(xy)xyyyxyx
xyxyxy(yx)xyyyyxx = xyxyxy(xy)xyyyyxx
xyxyxyyx(yx)xyyxy = xyxyxyyx(xy)xyyxy
xyxyxyyx(yx)xyyyx = xyxyxyyx(xy)xyyyx
xyxyxyyx(yx)yxxyy = xyxyxyyx(xy)yxxyy
xyxyxy(yx)yyxxxyy = xyxyxy(xy)yyxxxyy
xyxyxyyyx(yx)xyyx = xyxyxyyyx(xy)xyyx
xyxyxyyyx(yx)yxxy = xyxyxyyyx(xy)yxxy
xyxyxyy(yx)yyxxxy = xyxyxyy(xy)yyxxxy
xyxyxyy(yx)yyxxyx = xyxyxyy(xy)yyxxyx
xyxyyxxxyy(yx)yxy = xyxyyxxxyy(xy)yxy
xyxyyxxy(yx)xyyxy = xyxyyxxy(xy)xyyxy
xyxyyxxy(yx)xyyyx = xyxyyxxy(xy)xyyyx
xyxyyxxy(yx)yxxyy = xyxyyxxy(xy)yxxyy
xyxy(yx)xyyyyxxxy = xyxy(xy)xyyyyxxxy
xyxy(yx)xyyyyxxyx = xyxy(xy)xyyyyxxyx
xyxy(yx)xyyyyxyxx = xyxy(xy)xyyyyxyxx
xyxy(yx)xyyyyyxxx = xyxy(xy)xyyyyyxxx
xyxyyx(yx)xxyyyxy = xyxyyx(xy)xxyyyxy
xyxyyx(yx)xxyyyyx = xyxyyx(xy)xxyyyyx
xyxyyx(yx)xyxyyxy = xyxyyx(xy)xyxyyxy
xyxyyx(yxxy)xyyxy = xyxyyx(xyyx)xyyxy
xyxyyx(yx)xyxyyyx = xyxyyx(xy)xyxyyyx
xyxyyx(yxxy)xyyyx = xyxyyx(xyyx)xyyyx
xyxyyx(yx)xyyxxyy = xyxyyx(xy)xyyxxyy
xyxyyx(yxxy)yxxyy = xyxyyx(xyyx)yxxyy
xyxyyx(yx)xyyxyxy = xyxyyx(xy)xyyxyxy
xyxyyx(yx)xyyxyyx = xyxyyx(xy)xyyxyyx
xyxyyx(yx)xyyyxxy = xyxyyx(xy)xyyyxxy
xyxyyx(yx)xyyyxyx = xyxyyx(xy)xyyyxyx
xyxyyx(yx)xyyyyxx = xyxyyx(xy)xyyyyxx
xyxyyx(yx)yxxxyyy = xyxyyx(xy)yxxxyyy
xyxyyx(yx)yxxyxyy = xyxyyx(xy)yxxyxyy
xyxyyx(yxyx)xyyxy = xyxyyx(xyxy)xyyxy
xyxyyx(yx)yxxyyxy = xyxyyx(xy)yxxyyxy
xyxyyxyx(yx)xyyxy = xyxyyxyx(xy)xyyxy
xyxyyx(yxyx)xyyyx = xyxyyx(xyxy)xyyyx
xyxyyx(yx)yxxyyyx = xyxyyx(xy)yxxyyyx
xyxyyxyx(yx)xyyyx = xyxyyxyx(xy)xyyyx
xyxyyx(yxyx)yxxyy = xyxyyx(xyxy)yxxyy
xyxyyx(yx)yxyxxyy = xyxyyx(xy)yxyxxyy
xyxyyxyx(yx)yxxyy = xyxyyxyx(xy)yxxyy
xyxyyx(yx)yyxxxyy = xyxyyx(xy)yyxxxyy
xyxy(yx)yyxxxxyyy = xyxy(xy)yyxxxxyyy
xyxy(yx)yyxxxyxyy = xyxy(xy)yyxxxyxyy
xyxy(yx)yyxxxyyxy = xyxy(xy)yyxxxyyxy
xyxy(yx)yyxxxyyyx = xyxy(xy)yyxxxyyyx
xyxy(yx)yyxxyxxyy = xyxy(xy)yyxxyxxyy
xyxy(yx)yyxyxxxyy = xyxy(xy)yyxyxxxyy
xyxyyxyyx(yx)xyyx = xyxyyxyyx(xy)xyyx
xyxyyxyyx(yx)yxxy = xyxyyxyyx(xy)yxxy
xyxyyxy(yx)yyxxxy = xyxyyxy(xy)yyxxxy
xyxyyxy(yx)yyxxyx = xyxyyxy(xy)yyxxyx
xyxy(yx)yyyxxxxyy = xyxy(xy)yyyxxxxyy
xyxyyyxx(yx)xyxyy = xyxyyyxx(xy)xyxyy
xyxyyyxx(yx)xyyxy = xyxyyyxx(xy)xyyxy
xyxyyyxx(yx)xyyyx = xyxyyyxx(xy)xyyyx
xyxyyyxx(yx)yxxyy = xyxyyyxx(xy)yxxyy
xyxyyyxxy(yx)xyyx = xyxyyyxxy(xy)xyyx
xyxyyyxxy(yx)yxxy = xyxyyyxxy(xy)yxxy
xyxyyyx(yxx)xyyyx = xyxyyyx(xxy)xyyyx
xyxyyyx(yx)xxyyyx = xyxyyyx(xy)xxyyyx
xyxyyyx(yx)xyxyyx = xyxyyyx(xy)xyxyyx
xyxyyyx(yxxy)xyyx = xyxyyyx(xyyx)xyyx
xyxyyyx(yx)xyyxxy = xyxyyyx(xy)xyyxxy
xyxyyyx(yxxy)yxxy = xyxyyyx(xyyx)yxxy
xyxyyyx(yx)xyyxyx = xyxyyyx(xy)xyyxyx
xyxyyyx(yx)xyyyxx = xyxyyyx(xy)xyyyxx
xyxyyyx(yx)yxxxyy = xyxyyyx(xy)yxxxyy
xyxyyyx(yx)yxxyxy = xyxyyyx(xy)yxxyxy
xyxyyyx(yxyx)xyyx = xyxyyyx(xyxy)xyyx
xyxyyyx(yx)yxxyyx = xyxyyyx(xy)yxxyyx
xyxyyyxyx(yx)xyyx = xyxyyyxyx(xy)xyyx
xyxyyyx(yxyx)yxxy = xyxyyyx(xyxy)yxxy
xyxyyyx(yx)yxyxxy = xyxyyyx(xy)yxyxxy
xyxyyyxyx(yx)yxxy = xyxyyyxyx(xy)yxxy
xyxyyyx(yx)yxyxyx = xyxyyyx(xy)yxyxyx
xyxyyyx(yx)yyxxxy = xyxyyyx(xy)yyxxxy
xyxyyyx(yx)yyxxyx = xyxyyyx(xy)yyxxyx
xyxyy(yx)yyyxxxxy = xyxyy(xy)yyyxxxxy
xyxyy(yx)yyyxxxyx = xyxyy(xy)yyyxxxyx
xyxyy(yx)yyyxxyxx = xyxyy(xy)yyyxxyxx
xyxyyyyxx(yx)xyxy = xyxyyyyxx(xy)xyxy
xyxyyyyxx(yx)xyyx = xyxyyyyxx(xy)xyyx
xyxyyyyxx(yx)yxxy = xyxyyyyxx(xy)yxxy
xyxyyyyx(yx)xyyxx = xyxyyyyx(xy)xyyxx
xyxyyyyx(yx)yxxxy = xyxyyyyx(xy)yxxxy
xyxyyyyx(yx)yxxyx = xyxyyyyx(xy)yxxyx
xyxyyyyx(yx)yxyxx = xyxyyyyx(xy)yxyxx
xyxyyyyyxx(yx)xyx = xyxyyyyyxx(xy)xyx
xyyxxxxyy(yx)yxyy = xyyxxxxyy(xy)yxyy
xyyxxxxyyy(yx)yxy = xyyxxxxyyy(xy)yxy
xyyxxxyxyy(yx)yxy = xyyxxxyxyy(xy)yxy
xyyxxxy(yx)xyyxyy = xyyxxxy(xy)xyyxyy
xyyxxxy(yx)xyyyxy = xyyxxxy(xy)xyyyxy
xyyxxxy(yx)xyyyyx = xyyxxxy(xy)xyyyyx
xyyxxxy(yx)yxxyyy = xyyxxxy(xy)yxxyyy
xyyxxxyy(yx)xyyxy = xyyxxxyy(xy)xyyxy
xyyxxxyy(yx)xyyyx = xyyxxxyy(xy)xyyyx
xyyxxxyy(yx)yxxyy = xyyxxxyy(xy)yxxyy
xyyxxxyy(yx)yxyxy = xyyxxxyy(xy)yxyxy
xyyxxxyy(yx)yxyyx = xyyxxxyy(xy)yxyyx
xyyxxxyy(yx)yyxxy = xyyxxxyy(xy)yyxxy
xyyxx(yx)xxyyxyyy = xyyxx(xy)xxyyxyyy
xyyxx(yx)xxyyyxyy = xyyxx(xy)xxyyyxyy
xyyxx(yx)xxyyyyxy = xyyxx(xy)xxyyyyxy
xyyxx(yx)xxyyyyyx = xyyxx(xy)xxyyyyyx
xyyxx(yx)xyxxyyyy = xyyxx(xy)xyxxyyyy
xyyxxyxxyy(yx)yxy = xyyxxyxxyy(xy)yxy
xyyxx(yx)yxxxyyyy = xyyxx(xy)yxxxyyyy
xyyxxyxy(yx)xyyxy = xyyxxyxy(xy)xyyxy
xyyxxyxy(yx)xyyyx = xyyxxyxy(xy)xyyyx
xyyxxyxy(yx)yxxyy = xyyxxyxy(xy)yxxyy
xyyxxy(yx)xxyyyxy = xyyxxy(xy)xxyyyxy
xyyxxy(yx)xxyyyyx = xyyxxy(xy)xxyyyyx
xyyxxy(yx)xyxyyxy = xyyxxy(xy)xyxyyxy
xyyxxy(yxxy)xyyxy = xyyxxy(xyyx)xyyxy
xyyxxy(yx)xyxyyyx = xyyxxy(xy)xyxyyyx
xyyxxy(yxxy)xyyyx = xyyxxy(xyyx)xyyyx
xyyxxy(yx)xyyxxyy = xyyxxy(xy)xyyxxyy
xyyxxy(yxxy)yxxyy = xyyxxy(xyyx)yxxyy
xyyxxy(yx)xyyxyxy = xyyxxy(xy)xyyxyxy
xyyxxy(yx)xyyxyyx = xyyxxy(xy)xyyxyyx
xyyxxy(yx)xyyyxxy = xyyxxy(xy)xyyyxxy
xyyxxy(yx)xyyyxyx = xyyxxy(xy)xyyyxyx
xyyxxy(yx)xyyyyxx = xyyxxy(xy)xyyyyxx
xyyxxy(yx)yxxxyyy = xyyxxy(xy)yxxxyyy
xyyxxy(yx)yxxyxyy = xyyxxy(xy)yxxyxyy
xyyxxy(yxyx)xyyxy = xyyxxy(xyxy)xyyxy
xyyxxy(yx)yxxyyxy = xyyxxy(xy)yxxyyxy
xyyxxyyx(yx)xyyxy = xyyxxyyx(xy)xyyxy
xyyxxy(yxyx)xyyyx = xyyxxy(xyxy)xyyyx
xyyxxy(yx)yxxyyyx = xyyxxy(xy)yxxyyyx
xyyxxyyx(yx)xyyyx = xyyxxyyx(xy)xyyyx
xyyxxy(yxyx)yxxyy = xyyxxy(xyxy)yxxyy
xyyxxy(yx)yxyxxyy = xyyxxy(xy)yxyxxyy
xyyxxyyx(yx)yxxyy = xyyxxyyx(xy)yxxyy
xyyxxy(yx)yyxxxyy = xyyxxy(xy)yyxxxyy
xyyxxyy(yx)xyyyxx = xyyxxyy(xy)xyyyxx
xyyxxyyyx(yx)xyyx = xyyxxyyyx(xy)xyyx
xyyxxyyyx(yx)yxxy = xyyxxyyyx(xy)yxxy
xyyxxyy(yx)yxyyxx = xyyxxyy(xy)yxyyxx
xyyxxyy(yx)yyxxxy = xyyxxyy(xy)yyxxxy
xyyxxyy(yx)yyxxyx = xyyxxyy(xy)yyxxyx
xyyx(yxx)xxyyyyxy = xyyx(xxy)xxyyyyxy
xyyx(yx)xxxyyyyxy = xyyx(xy)xxxyyyyxy
xyyx(yxx)xxyyyyyx = xyyx(xxy)xxyyyyyx
xyyx(yx)xxxyyyyyx = xyyx(xy)xxxyyyyyx
xyyx(yx)xxyxyyyxy = xyyx(xy)xxyxyyyxy
xyyx(yx)xxyxyyyyx = xyyx(xy)xxyxyyyyx
xyyx(yx)xxyyxyyxy = xyyx(xy)xxyyxyyxy
xyyx(yxxxyyxy)yxy = xyyx(xyxxyyyx)yxy
xyyx(yx)xxyyxyyyx = xyyx(xy)xxyyxyyyx
xyyx(yx)xxyyyxxyy = xyyx(xy)xxyyyxxyy
xyyx(yxxxyyyx)yxy = xyyx(xyxxyyxy)yxy
xyyx(yx)xxyyyxyxy = xyyx(xy)xxyyyxyxy
xyyxyxxxyy(yx)yxy = xyyxyxxxyy(xy)yxy
xyyx(yx)xxyyyxyyx = xyyx(xy)xxyyyxyyx
xyyx(yx)xxyyyyxxy = xyyx(xy)xxyyyyxxy
xyyx(yx)xxyyyyxyx = xyyx(xy)xxyyyyxyx
xyyx(yx)xxyyyyyxx = xyyx(xy)xxyyyyyxx
xyyx(yx)xyxxyyyxy = xyyx(xy)xyxxyyyxy
xyyx(yxxy)xxyyyxy = xyyx(xyyx)xxyyyxy
xyyx(yx)xyxxyyyyx = xyyx(xy)xyxxyyyyx
xyyx(yxxy)xxyyyyx = xyyx(xyyx)xxyyyyx
xyyx(yx)xyxyxyyxy = xyyx(xy)xyxyxyyxy
xyyx(yxxyxy)xyyxy = xyyx(xyxyyx)xyyxy
xyyx(yxxy)xyxyyxy = xyyx(xyyx)xyxyyxy
xyyx(yxxyxy)xyyxy = xyyx(xyyxyx)xyyxy
xyyx(yx)xyxyxyyyx = xyyx(xy)xyxyxyyyx
xyyx(yxxyxy)xyyyx = xyyx(xyxyyx)xyyyx
xyyx(yxxy)xyxyyyx = xyyx(xyyx)xyxyyyx
xyyx(yxxyxy)xyyyx = xyyx(xyyxyx)xyyyx
xyyx(yx)xyxyyxxyy = xyyx(xy)xyxyyxxyy
xyyx(yxxyxy)yxxyy = xyyx(xyxyyx)yxxyy
xyyx(yxxy)xyyxxyy = xyyx(xyyx)xyyxxyy
xyyx(yxxyxy)yxxyy = xyyx(xyyxyx)yxxyy
xyyx(yx)xyxyyxyxy = xyyx(xy)xyxyyxyxy
xyyx(yxxy)xyyxyxy = xyyx(xyyx)xyyxyxy
xyyx(yx)xyxyyxyyx = xyyx(xy)xyxyyxyyx
xyyx(yxxy)xyyxyyx = xyyx(xyyx)xyyxyyx
xyyx(yx)xyxyyyxxy = xyyx(xy)xyxyyyxxy
xyyx(yxxy)xyyyxxy = xyyx(xyyx)xyyyxxy
xyyx(yx)xyxyyyxyx = xyyx(xy)xyxyyyxyx
xyyx(yxxy)xyyyxyx = xyyx(xyyx)xyyyxyx
xyyx(yx)xyxyyyyxx = xyyx(xy)xyxyyyyxx
xyyx(yxxy)xyyyyxx = xyyx(xyyx)xyyyyxx
xyyx(yx)xyyxxxyyy = xyyx(xy)xyyxxxyyy
xyyx(yxxy)yxxxyyy = xyyx(xyyx)yxxxyyy
xyyx(yx)xyyxxyxyy = xyyx(xy)xyyxxyxyy
xyyx(yxxy)yxxyxyy = xyyx(xyyx)yxxyxyy
xyyx(yxxyyx)xyyxy = xyyx(xyxyxy)xyyxy
xyyx(yx)xyyxxyyxy = xyyx(xy)xyyxxyyxy
xyyx(yxxyyx)xyyxy = xyyx(xyyxxy)xyyxy
xyyx(yxxy)yxxyyxy = xyyx(xyyx)yxxyyxy
xyyxyxxy(yx)xyyxy = xyyxyxxy(xy)xyyxy
xyyx(yxxyyx)xyyyx = xyyx(xyxyxy)xyyyx
xyyx(yx)xyyxxyyyx = xyyx(xy)xyyxxyyyx
xyyx(yxxyyx)xyyyx = xyyx(xyyxxy)xyyyx
xyyx(yxxy)yxxyyyx = xyyx(xyyx)yxxyyyx
xyyxyxxy(yx)xyyyx = xyyxyxxy(xy)xyyyx
xyyx(yxxyyx)yxxyy = xyyx(xyxyxy)yxxyy
xyyx(yx)xyyxyxxyy = xyyx(xy)xyyxyxxyy
xyyx(yxxyyx)yxxyy = xyyx(xyyxxy)yxxyy
xyyx(yxxy)yxyxxyy = xyyx(xyyx)yxyxxyy
xyyxyxxy(yx)yxxyy = xyyxyxxy(xy)yxxyy
xyyx(yx)xyyxyxyxy = xyyx(xy)xyyxyxyxy
xyyx(yx)xyyxyxyyx = xyyx(xy)xyyxyxyyx
xyyx(yx)xyyxyyxxy = xyyx(xy)xyyxyyxxy
xyyx(yx)xyyxyyxyx = xyyx(xy)xyyxyyxyx
xyyx(yx)xyyxyyyxx = xyyx(xy)xyyxyyyxx
xyyx(yx)xyyyxxxyy = xyyx(xy)xyyyxxxyy
xyyx(yxxy)yyxxxyy = xyyx(xyyx)yyxxxyy
xyyx(yx)xyyyxxyxy = xyyx(xy)xyyyxxyxy
xyyx(yx)xyyyxxyyx = xyyx(xy)xyyyxxyyx
xyyx(yx)xyyyxyxxy = xyyx(xy)xyyyxyxxy
xyyx(yx)xyyyxyxyx = xyyx(xy)xyyyxyxyx
xyyx(yx)xyyyxyyxx = xyyx(xy)xyyyxyyxx
xyyx(yx)xyyyyxxxy = xyyx(xy)xyyyyxxxy
xyyx(yx)xyyyyxxyx = xyyx(xy)xyyyyxxyx
xyyx(yx)xyyyyxyxx = xyyx(xy)xyyyyxyxx
xyyx(yx)xyyyyyxxx = xyyx(xy)xyyyyyxxx
xyyx(yx)yxxxxyyyy = xyyx(xy)yxxxxyyyy
xyyx(yx)yxxxyxyyy = xyyx(xy)yxxxyxyyy
xyyx(yx)yxxxyyxyy = xyyx(xy)yxxxyyxyy
xyyx(yxyx)xxyyyxy = xyyx(xyxy)xxyyyxy
xyyx(yx)yxxxyyyxy = xyyx(xy)yxxxyyyxy
xyyxyx(yx)xxyyyxy = xyyxyx(xy)xxyyyxy
xyyx(yxyx)xxyyyyx = xyyx(xyxy)xxyyyyx
xyyx(yx)yxxxyyyyx = xyyx(xy)yxxxyyyyx
xyyxyx(yx)xxyyyyx = xyyxyx(xy)xxyyyyx
xyyx(yx)yxxyxxyyy = xyyx(xy)yxxyxxyyy
xyyx(yx)yxxyxyxyy = xyyx(xy)yxxyxyxyy
xyyx(yxyx)xyxyyxy = xyyx(xyxy)xyxyyxy
xyyx(yxyxxy)xyyxy = xyyx(xyxyyx)xyyxy
xyyx(yx)yxxyxyyxy = xyyx(xy)yxxyxyyxy
xyyx(yxyxxy)xyyxy = xyyx(xyyxyx)xyyxy
xyyxyx(yx)xyxyyxy = xyyxyx(xy)xyxyyxy
xyyxyx(yxxy)xyyxy = xyyxyx(xyyx)xyyxy
xyyx(yxyx)xyxyyyx = xyyx(xyxy)xyxyyyx
xyyx(yxyxxy)xyyyx = xyyx(xyxyyx)xyyyx
xyyx(yx)yxxyxyyyx = xyyx(xy)yxxyxyyyx
xyyx(yxyxxy)xyyyx = xyyx(xyyxyx)xyyyx
xyyxyx(yx)xyxyyyx = xyyxyx(xy)xyxyyyx
xyyxyx(yxxy)xyyyx = xyyxyx(xyyx)xyyyx
xyyx(yxyx)xyyxxyy = xyyx(xyxy)xyyxxyy
xyyx(yxyxxy)yxxyy = xyyx(xyxyyx)yxxyy
xyyx(yx)yxxyyxxyy = xyyx(xy)yxxyyxxyy
xyyx(yxyxxy)yxxyy = xyyx(xyyxyx)yxxyy
xyyxyx(yx)xyyxxyy = xyyxyx(xy)xyyxxyy
xyyxyx(yxxy)yxxyy = xyyxyx(xyyx)yxxyy
xyyx(yxyx)xyyxyxy = xyyx(xyxy)xyyxyxy
xyyx(yx)yxxyyxyxy = xyyx(xy)yxxyyxyxy
xyyxyx(yx)xyyxyxy = xyyxyx(xy)xyyxyxy
xyyx(yxyx)xyyxyyx = xyyx(xyxy)xyyxyyx
xyyx(yx)yxxyyxyyx = xyyx(xy)yxxyyxyyx
xyyxyx(yx)xyyxyyx = xyyxyx(xy)xyyxyyx
xyyx(yxyx)xyyyxxy = xyyx(xyxy)xyyyxxy
xyyx(yx)yxxyyyxxy = xyyx(xy)yxxyyyxxy
xyyxyx(yx)xyyyxxy = xyyxyx(xy)xyyyxxy
xyyx(yxyx)xyyyxyx = xyyx(xyxy)xyyyxyx
xyyx(yx)yxxyyyxyx = xyyx(xy)yxxyyyxyx
xyyxyx(yx)xyyyxyx = xyyxyx(xy)xyyyxyx
xyyx(yxyx)xyyyyxx = xyyx(xyxy)xyyyyxx
xyyx(yx)yxxyyyyxx = xyyx(xy)yxxyyyyxx
xyyxyx(yx)xyyyyxx = xyyxyx(xy)xyyyyxx
xyyx(yxyx)yxxxyyy = xyyx(xyxy)yxxxyyy
xyyx(yx)yxyxxxyyy = xyyx(xy)yxyxxxyyy
xyyxyx(yx)yxxxyyy = xyyxyx(xy)yxxxyyy
xyyx(yxyx)yxxyxyy = xyyx(xyxy)yxxyxyy
xyyx(yx)yxyxxyxyy = xyyx(xy)yxyxxyxyy
xyyxyx(yx)yxxyxyy = xyyxyx(xy)yxxyxyy
xyyx(yxyxyx)xyyxy = xyyx(xyxyxy)xyyxy
xyyx(yxyx)yxxyyxy = xyyx(xyxy)yxxyyxy
xyyx(yxyxyx)xyyxy = xyyx(xyyxxy)xyyxy
xyyx(yx)yxyxxyyxy = xyyx(xy)yxyxxyyxy
xyyxyx(yxyx)xyyxy = xyyxyx(xyxy)xyyxy
xyyxyx(yx)yxxyyxy = xyyxyx(xy)yxxyyxy
xyyxyxyx(yx)xyyxy = xyyxyxyx(xy)xyyxy
xyyx(yxyxyx)xyyyx = xyyx(xyxyxy)xyyyx
xyyx(yxyx)yxxyyyx = xyyx(xyxy)yxxyyyx
xyyx(yxyxyx)xyyyx = xyyx(xyyxxy)xyyyx
xyyx(yx)yxyxxyyyx = xyyx(xy)yxyxxyyyx
xyyxyx(yxyx)xyyyx = xyyxyx(xyxy)xyyyx
xyyxyx(yx)yxxyyyx = xyyxyx(xy)yxxyyyx
xyyxyxyx(yx)xyyyx = xyyxyxyx(xy)xyyyx
xyyx(yxyxyx)yxxyy = xyyx(xyxyxy)yxxyy
xyyx(yxyx)yxyxxyy = xyyx(xyxy)yxyxxyy
xyyx(yxyxyx)yxxyy = xyyx(xyyxxy)yxxyy
xyyx(yx)yxyxyxxyy = xyyx(xy)yxyxyxxyy
xyyxyx(yxyx)yxxyy = xyyxyx(xyxy)yxxyy
xyyxyx(yx)yxyxxyy = xyyxyx(xy)yxyxxyy
xyyxyxyx(yx)yxxyy = xyyxyxyx(xy)yxxyy
xyyx(yxyx)yyxxxyy = xyyx(xyxy)yyxxxyy
xyyx(yx)yxyyxxxyy = xyyx(xy)yxyyxxxyy
xyyxyx(yx)yyxxxyy = xyyxyx(xy)yyxxxyy
xyyx(yx)yyxxxxyyy = xyyx(xy)yyxxxxyyy
xyyx(yx)yyxxxyxyy = xyyx(xy)yyxxxyxyy
xyyx(yx)yyxxxyyxy = xyyx(xy)yyxxxyyxy
xyyx(yx)yyxxxyyyx = xyyx(xy)yyxxxyyyx
xyyx(yx)yyxxyxxyy = xyyx(xy)yyxxyxxyy
xyyxyxy(yx)xyyyxx = xyyxyxy(xy)xyyyxx
xyyx(yx)yyxyxxxyy = xyyx(xy)yyxyxxxyy
xyyxyxyyx(yx)xyyx = xyyxyxyyx(xy)xyyx
xyyxyxyyx(yx)yxxy = xyyxyxyyx(xy)yxxy
xyyxyxy(yx)yyxxxy = xyyxyxy(xy)yyxxxy
xyyx(yx)yyyxxxxyy = xyyx(xy)yyyxxxxyy
xyyxyyxx(yx)xyxyy = xyyxyyxx(xy)xyxyy
xyyxyyxx(yx)xyyxy = xyyxyyxx(xy)xyyxy
xyyxyyxx(yx)xyyyx = xyyxyyxx(xy)xyyyx
xyyxyyxx(yx)yxxyy = xyyxyyxx(xy)yxxyy
xyyxyyxxy(yx)xyyx = xyyxyyxxy(xy)xyyx
xyyxyyxxy(yx)yxxy = xyyxyyxxy(xy)yxxy
xyyxy(yx)xyyyyxxx = xyyxy(xy)xyyyyxxx
xyyxyyx(yxx)xyyyx = xyyxyyx(xxy)xyyyx
xyyxyyx(yx)xxyyyx = xyyxyyx(xy)xxyyyx
xyyxyyx(yx)xyxyyx = xyyxyyx(xy)xyxyyx
xyyxyyx(yxxy)xyyx = xyyxyyx(xyyx)xyyx
xyyxyyx(yx)xyyxxy = xyyxyyx(xy)xyyxxy
xyyxyyx(yxxy)yxxy = xyyxyyx(xyyx)yxxy
xyyxyyx(yx)xyyxyx = xyyxyyx(xy)xyyxyx
xyyxyyx(yx)xyyyxx = xyyxyyx(xy)xyyyxx
xyyxyyx(yx)yxxxyy = xyyxyyx(xy)yxxxyy
xyyxyyx(yx)yxxyxy = xyyxyyx(xy)yxxyxy
xyyxyyx(yxyx)xyyx = xyyxyyx(xyxy)xyyx
xyyxyyx(yx)yxxyyx = xyyxyyx(xy)yxxyyx
xyyxyyxyx(yx)xyyx = xyyxyyxyx(xy)xyyx
xyyxyyx(yxyx)yxxy = xyyxyyx(xyxy)yxxy
xyyxyyx(yx)yxyxxy = xyyxyyx(xy)yxyxxy
xyyxyyxyx(yx)yxxy = xyyxyyxyx(xy)yxxy
xyyxyyx(yx)yyxxxy = xyyxyyx(xy)yyxxxy
xyyx(yyx)yyxxxxyy = xyyx(xyy)yyxxxxyy
xyyxy(yx)yyxxxxyy = xyyxy(xy)yyxxxxyy
xyyxy(yx)yyxxxyxy = xyyxy(xy)yyxxxyxy
xyyxy(yx)yyxxxyyx = xyyxy(xy)yyxxxyyx
xyyxy(yx)yyxxyxxy = xyyxy(xy)yyxxyxxy
xyyxy(yx)yyxxyxyx = xyyxy(xy)yyxxyxyx
xyyxy(yx)yyxxyyxx = xyyxy(xy)yyxxyyxx
xyyxy(yx)yyxyxxxy = xyyxy(xy)yyxyxxxy
xyyxy(yx)yyxyxxyx = xyyxy(xy)yyxyxxyx
xyyxy(yx)yyyxxxxy = xyyxy(xy)yyyxxxxy
xyyxy(yx)yyyxxxyx = xyyxy(xy)yyyxxxyx
xyyxyyyxx(yx)xyxy = xyyxyyyxx(xy)xyxy
xyyxyyyxx(yx)xyyx = xyyxyyyxx(xy)xyyx
xyyxyyyxx(yx)yxxy = xyyxyyyxx(xy)yxxy
xyyxyyyx(yx)xyyxx = xyyxyyyx(xy)xyyxx
xyyxyyyx(yx)yxxxy = xyyxyyyx(xy)yxxxy
xyyxyyyx(yx)yxxyx = xyyxyyyx(xy)yxxyx
xyyxyyyyxx(yx)xyx = xyyxyyyyxx(xy)xyx
xyyyxxxxyy(yx)yxy = xyyyxxxxyy(xy)yxy
xyyyxxxy(yx)xyyxy = xyyyxxxy(xy)xyyxy
xyyyxxxy(yx)xyyyx = xyyyxxxy(xy)xyyyx
xyyyxxxy(yx)yxxyy = xyyyxxxy(xy)yxxyy
xyyyxxxyy(yx)xyyx = xyyyxxxyy(xy)xyyx
xyyyxxxyy(yx)yxxy = xyyyxxxyy(xy)yxxy
xyyyxxxyy(yx)yxyx = xyyyxxxyy(xy)yxyx
xyyyxx(yx)xxyyxyy = xyyyxx(xy)xxyyxyy
xyyyxx(yx)xxyyyxy = xyyyxx(xy)xxyyyxy
xyyyxx(yx)xxyyyyx = xyyyxx(xy)xxyyyyx
xyyyxx(yx)xyxxyyy = xyyyxx(xy)xyxxyyy
xyyyxx(yx)xyxyxyy = xyyyxx(xy)xyxyxyy
xyyyxx(yx)xyxyyxy = xyyyxx(xy)xyxyyxy
xyyyxx(yxxy)xyyxy = xyyyxx(xyyx)xyyxy
xyyyxx(yx)xyxyyyx = xyyyxx(xy)xyxyyyx
xyyyxx(yxxy)xyyyx = xyyyxx(xyyx)xyyyx
xyyyxx(yx)xyyxxyy = xyyyxx(xy)xyyxxyy
xyyyxx(yxxy)yxxyy = xyyyxx(xyyx)yxxyy
xyyyxx(yx)xyyxyxy = xyyyxx(xy)xyyxyxy
xyyyxx(yx)xyyxyyx = xyyyxx(xy)xyyxyyx
xyyyxx(yx)xyyyxxy = xyyyxx(xy)xyyyxxy
xyyyxx(yx)xyyyxyx = xyyyxx(xy)xyyyxyx
xyyyxx(yx)xyyyyxx = xyyyxx(xy)xyyyyxx
xyyyxx(yx)yxxxyyy = xyyyxx(xy)yxxxyyy
xyyyxx(yx)yxxyxyy = xyyyxx(xy)yxxyxyy
xyyyxx(yxyx)xyyxy = xyyyxx(xyxy)xyyxy
xyyyxx(yx)yxxyyxy = xyyyxx(xy)yxxyyxy
xyyyxxyx(yx)xyyxy = xyyyxxyx(xy)xyyxy
xyyyxx(yxyx)xyyyx = xyyyxx(xyxy)xyyyx
xyyyxx(yx)yxxyyyx = xyyyxx(xy)yxxyyyx
xyyyxxyx(yx)xyyyx = xyyyxxyx(xy)xyyyx
xyyyxx(yxyx)yxxyy = xyyyxx(xyxy)yxxyy
xyyyxx(yx)yxyxxyy = xyyyxx(xy)yxyxxyy
xyyyxxyx(yx)yxxyy = xyyyxxyx(xy)yxxyy
xyyyxx(yx)yyxxxyy = xyyyxx(xy)yyxxxyy
xyyyxxyxy(yx)xyyx = xyyyxxyxy(xy)xyyx
xyyyxxyxy(yx)yxxy = xyyyxxyxy(xy)yxxy
xyyyxx(yyxx)xyyyx = xyyyxx(xyxy)xyyyx
xyyyxx(yyx)xxyyyx = xyyyxx(xyy)xxyyyx
xyyyxxy(yxx)xyyyx = xyyyxxy(xxy)xyyyx
xyyyxxy(yx)xxyyyx = xyyyxxy(xy)xxyyyx
xyyyxxy(yx)xyxyyx = xyyyxxy(xy)xyxyyx
xyyyxxy(yxxy)xyyx = xyyyxxy(xyyx)xyyx
xyyyxxy(yx)xyyxxy = xyyyxxy(xy)xyyxxy
xyyyxxy(yxxy)yxxy = xyyyxxy(xyyx)yxxy
xyyyxxy(yx)xyyxyx = xyyyxxy(xy)xyyxyx
xyyyxxy(yx)xyyyxx = xyyyxxy(xy)xyyyxx
xyyyxx(yyx)yxxxyy = xyyyxx(xyy)yxxxyy
xyyyxxy(yx)yxxxyy = xyyyxxy(xy)yxxxyy
xyyyxxy(yx)yxxyxy = xyyyxxy(xy)yxxyxy
xyyyxxy(yxyx)xyyx = xyyyxxy(xyxy)xyyx
xyyyxxy(yx)yxxyyx = xyyyxxy(xy)yxxyyx
xyyyxxyyx(yx)xyyx = xyyyxxyyx(xy)xyyx
xyyyxxy(yxyx)yxxy = xyyyxxy(xyxy)yxxy
xyyyxxy(yx)yxyxxy = xyyyxxy(xy)yxyxxy
xyyyxxyyx(yx)yxxy = xyyyxxyyx(xy)yxxy
xyyyxxy(yx)yyxxxy = xyyyxxy(xy)yyxxxy
xyyyx(yxx)xxyyyyx = xyyyx(xxy)xxyyyyx
xyyyx(yx)xxxyyyyx = xyyyx(xy)xxxyyyyx
xyyyx(yxx)xyxyyyx = xyyyx(xxy)xyxyyyx
xyyyx(yxxxy)xyyyx = xyyyx(xxyyx)xyyyx
xyyyx(yx)xxyxyyyx = xyyyx(xy)xxyxyyyx
xyyyx(yxxxy)xyyyx = xyyyx(xyxyx)xyyyx
xyyyx(yxxxy)xyyyx = xyyyx(xyyxx)xyyyx
xyyyx(yxx)xyyxyyx = xyyyx(xxy)xyyxyyx
xyyyx(yx)xxyyxyyx = xyyyx(xy)xxyyxyyx
xyyyx(yxx)xyyyxxy = xyyyx(xxy)xyyyxxy
xyyyx(yx)xxyyyxxy = xyyyx(xy)xxyyyxxy
xyyyx(yxx)xyyyxyx = xyyyx(xxy)xyyyxyx
xyyyx(yx)xxyyyxyx = xyyyx(xy)xxyyyxyx
xyyyx(yxx)xyyyyxx = xyyyx(xxy)xyyyyxx
xyyyx(yx)xxyyyyxx = xyyyx(xy)xxyyyyxx
xyyyxyxx(yx)xyxyy = xyyyxyxx(xy)xyxyy
xyyyxyxx(yx)xyyxy = xyyyxyxx(xy)xyyxy
xyyyx(yxxyx)xyyyx = xyyyx(xxyxy)xyyyx
xyyyx(yxx)yxxyyyx = xyyyx(xxy)yxxyyyx
xyyyx(yxxyx)xyyyx = xyyyx(xyxxy)xyyyx
xyyyx(yx)xyxxyyyx = xyyyx(xy)xyxxyyyx
xyyyx(yxxy)xxyyyx = xyyyx(xyyx)xxyyyx
xyyyxyxx(yx)xyyyx = xyyyxyxx(xy)xyyyx
xyyyxyxx(yx)yxxyy = xyyyxyxx(xy)yxxyy
xyyyx(yx)xyxyxyyx = xyyyx(xy)xyxyxyyx
xyyyx(yxxyxy)xyyx = xyyyx(xyxyyx)xyyx
xyyyx(yxxy)xyxyyx = xyyyx(xyyx)xyxyyx
xyyyx(yxxyxy)xyyx = xyyyx(xyyxyx)xyyx
xyyyx(yx)xyxyyxxy = xyyyx(xy)xyxyyxxy
xyyyx(yxxyxy)yxxy = xyyyx(xyxyyx)yxxy
xyyyx(yxxy)xyyxxy = xyyyx(xyyx)xyyxxy
xyyyx(yxxyxy)yxxy = xyyyx(xyyxyx)yxxy
xyyyx(yx)xyxyyxyx = xyyyx(xy)xyxyyxyx
xyyyx(yxxy)xyyxyx = xyyyx(xyyx)xyyxyx
xyyyx(yx)xyxyyyxx = xyyyx(xy)xyxyyyxx
xyyyx(yxxy)xyyyxx = xyyyx(xyyx)xyyyxx
xyyyx(yxx)yyxxxyy = xyyyx(xxy)yyxxxyy
xyyyx(yx)xyyxxxyy = xyyyx(xy)xyyxxxyy
xyyyx(yxxy)yxxxyy = xyyyx(xyyx)yxxxyy
xyyyx(yx)xyyxxyxy = xyyyx(xy)xyyxxyxy
xyyyx(yxxy)yxxyxy = xyyyx(xyyx)yxxyxy
xyyyx(yxxyyx)xyyx = xyyyx(xyxyxy)xyyx
xyyyx(yx)xyyxxyyx = xyyyx(xy)xyyxxyyx
xyyyx(yxxyyx)xyyx = xyyyx(xyyxxy)xyyx
xyyyx(yxxy)yxxyyx = xyyyx(xyyx)yxxyyx
xyyyxyxxy(yx)xyyx = xyyyxyxxy(xy)xyyx
xyyyx(yxxyyx)yxxy = xyyyx(xyxyxy)yxxy
xyyyx(yx)xyyxyxxy = xyyyx(xy)xyyxyxxy
xyyyx(yxxyyx)yxxy = xyyyx(xyyxxy)yxxy
xyyyx(yxxy)yxyxxy = xyyyx(xyyx)yxyxxy
xyyyxyxxy(yx)yxxy = xyyyxyxxy(xy)yxxy
xyyyx(yx)xyyxyxyx = xyyyx(xy)xyyxyxyx
xyyyx(yx)xyyxyyxx = xyyyx(xy)xyyxyyxx
xyyyx(yx)xyyyxxxy = xyyyx(xy)xyyyxxxy
xyyyx(yxxy)yyxxxy = xyyyx(xyyx)yyxxxy
xyyyx(yx)xyyyxxyx = xyyyx(xy)xyyyxxyx
xyyyx(yx)xyyyxyxx = xyyyx(xy)xyyyxyxx
xyyyx(yx)xyyyyxxx = xyyyx(xy)xyyyyxxx
xyyyx(yx)yxxxxyyy = xyyyx(xy)yxxxxyyy
xyyyx(yx)yxxxyxyy = xyyyx(xy)yxxxyxyy
xyyyx(yx)yxxxyyxy = xyyyx(xy)yxxxyyxy
xyyyx(yxyxx)xyyyx = xyyyx(xxyxy)xyyyx
xyyyx(yxyx)xxyyyx = xyyyx(xxyy)xxyyyx
xyyyx(yxyxx)xyyyx = xyyyx(xyxxy)xyyyx
xyyyx(yxyx)xxyyyx = xyyyx(xyxy)xxyyyx
xyyyx(yx)yxxxyyyx = xyyyx(xy)yxxxyyyx
xyyyxyx(yxx)xyyyx = xyyyxyx(xxy)xyyyx
xyyyxyx(yx)xxyyyx = xyyyxyx(xy)xxyyyx
xyyyx(yx)yxxyxxyy = xyyyx(xy)yxxyxxyy
xyyyx(yx)yxxyxyxy = xyyyx(xy)yxxyxyxy
xyyyx(yxyx)xyxyyx = xyyyx(xyxy)xyxyyx
xyyyx(yxyxxy)xyyx = xyyyx(xyxyyx)xyyx
xyyyx(yx)yxxyxyyx = xyyyx(xy)yxxyxyyx
xyyyx(yxyxxy)xyyx = xyyyx(xyyxyx)xyyx
xyyyxyx(yx)xyxyyx = xyyyxyx(xy)xyxyyx
xyyyxyx(yxxy)xyyx = xyyyxyx(xyyx)xyyx
xyyyx(yxyx)xyyxxy = xyyyx(xyxy)xyyxxy
xyyyx(yxyxxy)yxxy = xyyyx(xyxyyx)yxxy
xyyyx(yx)yxxyyxxy = xyyyx(xy)yxxyyxxy
xyyyx(yxyxxy)yxxy = xyyyx(xyyxyx)yxxy
xyyyxyx(yx)xyyxxy = xyyyxyx(xy)xyyxxy
xyyyxyx(yxxy)yxxy = xyyyxyx(xyyx)yxxy
xyyyx(yxyx)xyyxyx = xyyyx(xyxy)xyyxyx
xyyyx(yx)yxxyyxyx = xyyyx(xy)yxxyyxyx
xyyyxyx(yx)xyyxyx = xyyyxyx(xy)xyyxyx
xyyyx(yxyx)xyyyxx = xyyyx(xyxy)xyyyxx
xyyyx(yx)yxxyyyxx = xyyyx(xy)yxxyyyxx
xyyyxyx(yx)xyyyxx = xyyyxyx(xy)xyyyxx
xyyyx(yxyx)yxxxyy = xyyyx(xxyy)yxxxyy
xyyyx(yxyx)yxxxyy = xyyyx(xyxy)yxxxyy
xyyyx(yx)yxyxxxyy = xyyyx(xy)yxyxxxyy
xyyyxyx(yx)yxxxyy = xyyyxyx(xy)yxxxyy
xyyyx(yxyx)yxxyxy = xyyyx(xyxy)yxxyxy
xyyyx(yx)yxyxxyxy = xyyyx(xy)yxyxxyxy
xyyyxyx(yx)yxxyxy = xyyyxyx(xy)yxxyxy
xyyyx(yxyxyx)xyyx = xyyyx(xyxyxy)xyyx
xyyyx(yxyx)yxxyyx = xyyyx(xyxy)yxxyyx
xyyyx(yxyxyx)xyyx = xyyyx(xyyxxy)xyyx
xyyyx(yx)yxyxxyyx = xyyyx(xy)yxyxxyyx
xyyyxyx(yxyx)xyyx = xyyyxyx(xyxy)xyyx
xyyyxyx(yx)yxxyyx = xyyyxyx(xy)yxxyyx
xyyyxyxyx(yx)xyyx = xyyyxyxyx(xy)xyyx
xyyyx(yxyxyx)yxxy = xyyyx(xyxyxy)yxxy
xyyyx(yxyx)yxyxxy = xyyyx(xyxy)yxyxxy
xyyyx(yxyxyx)yxxy = xyyyx(xyyxxy)yxxy
xyyyx(yx)yxyxyxxy = xyyyx(xy)yxyxyxxy
xyyyxyx(yxyx)yxxy = xyyyxyx(xyxy)yxxy
xyyyxyx(yx)yxyxxy = xyyyxyx(xy)yxyxxy
xyyyxyxyx(yx)yxxy = xyyyxyxyx(xy)yxxy
xyyyx(yx)yxyxyxyx = xyyyx(xy)yxyxyxyx
xyyyx(yx)yxyxyyxx = xyyyx(xy)yxyxyyxx
xyyyx(yxyx)yyxxxy = xyyyx(xyxy)yyxxxy
xyyyx(yx)yxyyxxxy = xyyyx(xy)yxyyxxxy
xyyyxyx(yx)yyxxxy = xyyyxyx(xy)yyxxxy
xyyyx(yx)yxyyxxyx = xyyyx(xy)yxyyxxyx
xyyyx(yx)yyxxxxyy = xyyyx(xy)yyxxxxyy
xyyyx(yx)yyxxxyxy = xyyyx(xy)yyxxxyxy
xyyyx(yx)yyxxxyyx = xyyyx(xy)yyxxxyyx
xyyyx(yx)yyxxyxxy = xyyyx(xy)yyxxyxxy
xyyyx(yx)yyxxyxyx = xyyyx(xy)yyxxyxyx
xyyyx(yx)yyxxyyxx = xyyyx(xy)yyxxyyxx
xyyyx(yx)yyxyxxxy = xyyyx(xy)yyxyxxxy
xyyyx(yx)yyxyxxyx = xyyyx(xy)yyxyxxyx
xyyyx(yx)yyyxxxxy = xyyyx(xy)yyyxxxxy
xyyyx(yx)yyyxxxyx = xyyyx(xy)yyyxxxyx
xyyyxyyxx(yx)xyxy = xyyyxyyxx(xy)xyxy
xyyyxyyxx(yx)xyyx = xyyyxyyxx(xy)xyyx
xyyyxyyxx(yx)yxxy = xyyyxyyxx(xy)yxxy
xyyyxyyx(yx)xyyxx = xyyyxyyx(xy)xyyxx
xyyyxyyx(yx)yxxxy = xyyyxyyx(xy)yxxxy
xyyyxyyx(yx)yxxyx = xyyyxyyx(xy)yxxyx
xyyyx(yyx)yyxxxxy = xyyyx(xyy)yyxxxxy
xyyyxy(yx)yyxxxxy = xyyyxy(xy)yyxxxxy
xyyyx(yyx)yyxxxyx = xyyyx(xyy)yyxxxyx
xyyyxy(yx)yyxxxyx = xyyyxy(xy)yyxxxyx
xyyyxy(yx)yyxxyxx = xyyyxy(xy)yyxxyxx
xyyyxyyyxx(yx)xyx = xyyyxyyyxx(xy)xyx
xyyyyxxx(yx)xyxyy = xyyyyxxx(xy)xyxyy
xyyyyxxx(yx)xyyxy = xyyyyxxx(xy)xyyxy
xyyyyxxx(yx)xyyyx = xyyyyxxx(xy)xyyyx
xyyyyxxx(yx)yxxyy = xyyyyxxx(xy)yxxyy
xyyyyxxxy(yx)xyyx = xyyyyxxxy(xy)xyyx
xyyyyxxxy(yx)yxxy = xyyyyxxxy(xy)yxxy
xyyyyxx(yxx)xyyxy = xyyyyxx(xxy)xyyxy
xyyyyxx(yx)xxyyxy = xyyyyxx(xy)xxyyxy
xyyyyxx(yxx)xyyyx = xyyyyxx(xxy)xyyyx
xyyyyxx(yx)xxyyyx = xyyyyxx(xy)xxyyyx
xyyyyxx(yxx)yxxyy = xyyyyxx(xxy)yxxyy
xyyyyxx(yx)xyxxyy = xyyyyxx(xy)xyxxyy
xyyyyxx(yx)xyxyxy = xyyyyxx(xy)xyxyxy
xyyyyxx(yx)xyxyyx = xyyyyxx(xy)xyxyyx
xyyyyxx(yxxy)xyyx = xyyyyxx(xyyx)xyyx
xyyyyxx(yx)xyyxxy = xyyyyxx(xy)xyyxxy
xyyyyxx(yxxy)yxxy = xyyyyxx(xyyx)yxxy
xyyyyxx(yx)xyyxyx = xyyyyxx(xy)xyyxyx
xyyyyxx(yx)xyyyxx = xyyyyxx(xy)xyyyxx
xyyyyxx(yx)yxxxyy = xyyyyxx(xy)yxxxyy
xyyyyxx(yx)yxxyxy = xyyyyxx(xy)yxxyxy
xyyyyxx(yxyx)xyyx = xyyyyxx(xyxy)xyyx
xyyyyxx(yx)yxxyyx = xyyyyxx(xy)yxxyyx
xyyyyxxyx(yx)xyyx = xyyyyxxyx(xy)xyyx
xyyyyxx(yxyx)yxxy = xyyyyxx(xyxy)yxxy
xyyyyxx(yx)yxyxxy = xyyyyxx(xy)yxyxxy
xyyyyxxyx(yx)yxxy = xyyyyxxyx(xy)yxxy
xyyyyxx(yx)yyxxxy = xyyyyxx(xy)yyxxxy
xyyyyxxy(yx)xyyxx = xyyyyxxy(xy)xyyxx
xyyyyxx(yyx)yxxxy = xyyyyxx(xyy)yxxxy
xyyyyxxy(yx)yxxxy = xyyyyxxy(xy)yxxxy
xyyyyxxy(yx)yxxyx = xyyyyxxy(xy)yxxyx
xyyyyx(yxx)xyyyxx = xyyyyx(xxy)xyyyxx
xyyyyx(yx)xxyyyxx = xyyyyx(xy)xxyyyxx
xyyyyxyxx(yx)xyxy = xyyyyxyxx(xy)xyxy
xyyyyxyxx(yx)xyyx = xyyyyxyxx(xy)xyyx
xyyyyxyxx(yx)yxxy = xyyyyxyxx(xy)yxxy
xyyyyx(yx)xyxyyxx = xyyyyx(xy)xyxyyxx
xyyyyx(yxxy)xyyxx = xyyyyx(xyyx)xyyxx
xyyyyx(yxx)yyxxxy = xyyyyx(xxy)yyxxxy
xyyyyx(yx)xyyxxxy = xyyyyx(xy)xyyxxxy
xyyyyx(yxxy)yxxxy = xyyyyx(xyyx)yxxxy
xyyyyx(yx)xyyxxyx = xyyyyx(xy)xyyxxyx
xyyyyx(yxxy)yxxyx = xyyyyx(xyyx)yxxyx
xyyyyx(yx)xyyxyxx = xyyyyx(xy)xyyxyxx
xyyyyx(yx)xyyyxxx = xyyyyx(xy)xyyyxxx
xyyyyx(yx)yxxxxyy = xyyyyx(xy)yxxxxyy
xyyyyx(yx)yxxxyxy = xyyyyx(xy)yxxxyxy
xyyyyx(yx)yxxxyyx = xyyyyx(xy)yxxxyyx
xyyyyx(yx)yxxyxxy = xyyyyx(xy)yxxyxxy
xyyyyx(yx)yxxyxyx = xyyyyx(xy)yxxyxyx
xyyyyx(yxyx)xyyxx = xyyyyx(xyxy)xyyxx
xyyyyx(yx)yxxyyxx = xyyyyx(xy)yxxyyxx
xyyyyxyx(yx)xyyxx = xyyyyxyx(xy)xyyxx
xyyyyx(yxyx)yxxxy = xyyyyx(xxyy)yxxxy
xyyyyx(yxyx)yxxxy = xyyyyx(xyxy)yxxxy
xyyyyx(yx)yxyxxxy = xyyyyx(xy)yxyxxxy
xyyyyxyx(yx)yxxxy = xyyyyxyx(xy)yxxxy
xyyyyx(yxyx)yxxyx = xyyyyx(xyxy)yxxyx
xyyyyx(yx)yxyxxyx = xyyyyx(xy)yxyxxyx
xyyyyxyx(yx)yxxyx = xyyyyxyx(xy)yxxyx
xyyyyx(yx)yxyxyxx = xyyyyx(xy)yxyxyxx
xyyyyx(yx)yxyyxxx = xyyyyx(xy)yxyyxxx
xyyyyx(yx)yyxxxxy = xyyyyx(xy)yyxxxxy
xyyyyx(yx)yyxxxyx = xyyyyx(xy)yyxxxyx
xyyyyx(yx)yyxxyxx = xyyyyx(xy)yyxxyxx
xyyyyxyyxx(yx)xyx = xyyyyxyyxx(xy)xyx
xyyyyyxxx(yx)xyxy = xyyyyyxxx(xy)xyxy
xyyyyyxxx(yx)xyyx = xyyyyyxxx(xy)xyyx
xyyyyyxxx(yx)yxxy = xyyyyyxxx(xy)yxxy
xyyyyyxx(yxx)xyyx = xyyyyyxx(xxy)xyyx
xyyyyyxx(yx)xxyyx = xyyyyyxx(xy)xxyyx
xyyyyyxx(yxx)yxxy = xyyyyyxx(xxy)yxxy
xyyyyyxx(yx)xyxxy = xyyyyyxx(xy)xyxxy
xyyyyyxx(yx)xyxyx = xyyyyyxx(xy)xyxyx
xyyyyyxx(yx)xyyxx = xyyyyyxx(xy)xyyxx
xyyyyyxx(yx)yxxxy = xyyyyyxx(xy)yxxxy
xyyyyyxx(yx)yxxyx = xyyyyyxx(xy)yxxyx
xyyyyyxyxx(yx)xyx = xyyyyyxyxx(xy)xyx
xyyyyyx(yx)xyyxxx = xyyyyyx(xy)xyyxxx
xyyyyyx(yx)yxxxxy = xyyyyyx(xy)yxxxxy
xyyyyyx(yx)yxxxyx = xyyyyyx(xy)yxxxyx
xyyyyyx(yx)yxxyxx = xyyyyyx(xy)yxxyxx
xyyyyyx(yx)yxyxxx = xyyyyyx(xy)yxyxxx
xyyyyyyxxx(yx)xyx = xyyyyyyxxx(xy)xyx
xyyyyyyxx(yx)xyxx = xyyyyyyxx(xy)xyxx
#  relations (8,7)
xxxxxyyyyx(yx)yxy = xxxxxyyyyx(xy)yxy
xxxxyxxyy(yx)yxyy = xxxxyxxyy(xy)yxyy
xxxxyxy(yx)xyyyyx = xxxxyxy(xy)xyyyyx
xxxxyyx(yx)xyyxyy = xxxxyyx(xy)xyyxyy
xxxxyyx(yx)xyyyxy = xxxxyyx(xy)xyyyxy
xxxxyyx(yx)xyyyyx = xxxxyyx(xy)xyyyyx
xxxxyyx(yx)yxxyyy = xxxxyyx(xy)yxxyyy
xxxxyyxy(yx)yyxxy = xxxxyyxy(xy)yyxxy
xxxxyyyx(yx)xyyxy = xxxxyyyx(xy)xyyxy
xxxxyyyx(yx)xyyyx = xxxxyyyx(xy)xyyyx
xxxxyyyx(yx)yxxyy = xxxxyyyx(xy)yxxyy
xxxxyyyx(yx)yxyxy = xxxxyyyx(xy)yxyxy
xxxxyyyx(yx)yyxxy = xxxxyyyx(xy)yyxxy
xxxxyyyyx(yx)xyyx = xxxxyyyyx(xy)xyyx
xxxxyyyyx(yx)yxxy = xxxxyyyyx(xy)yxxy
xxxxyyyyx(yx)yxyx = xxxxyyyyx(xy)yxyx
xxxyxxxyy(yx)yxyy = xxxyxxxyy(xy)yxyy
xxxyxxy(yx)xyyxyy = xxxyxxy(xy)xyyxyy
xxxyxxy(yx)xyyyxy = xxxyxxy(xy)xyyyxy
xxxyxxy(yx)xyyyyx = xxxyxxy(xy)xyyyyx
xxxyxxy(yx)yxxyyy = xxxyxxy(xy)yxxyyy
xxxyxxyy(yx)xyyyx = xxxyxxyy(xy)xyyyx
xxxyxxyy(yx)yxyyx = xxxyxxyy(xy)yxyyx
xxxyxxyy(yx)yyxxy = xxxyxxyy(xy)yyxxy
xxxyx(yx)xxyyxyyy = xxxyx(xy)xxyyxyyy
xxxyx(yx)xxyyyxyy = xxxyx(xy)xxyyyxyy
xxxyx(yx)xxyyyyxy = xxxyx(xy)xxyyyyxy
xxxyx(yx)xxyyyyyx = xxxyx(xy)xxyyyyyx
xxxyxyxy(yx)xyyyx = xxxyxyxy(xy)xyyyx
xxxyxy(yx)xyyyyxx = xxxyxy(xy)xyyyyxx
xxxyxyyx(yx)xyyxy = xxxyxyyx(xy)xyyxy
xxxyxyyx(yx)xyyyx = xxxyxyyx(xy)xyyyx
xxxyxyyx(yx)yxxyy = xxxyxyyx(xy)yxxyy
xxxyxy(yx)yyxxxyy = xxxyxy(xy)yyxxxyy
xxxyxyyyx(yx)xyyx = xxxyxyyyx(xy)xyyx
xxxyxyyyx(yx)yxxy = xxxyxyyyx(xy)yxxy
xxxyyxxxyy(yx)yxy = xxxyyxxxyy(xy)yxy
xxxyyxxy(yx)xyyxy = xxxyyxxy(xy)xyyxy
xxxyyxxy(yx)xyyyx = xxxyyxxy(xy)xyyyx
xxxyyxxy(yx)yxxyy = xxxyyxxy(xy)yxxyy
xxxyyx(yx)xxyyyxy = xxxyyx(xy)xxyyyxy
xxxyyx(yx)xxyyyyx = xxxyyx(xy)xxyyyyx
xxxyyx(yx)xyxyyxy = xxxyyx(xy)xyxyyxy
xxxyyx(yxxy)xyyxy = xxxyyx(xyyx)xyyxy
xxxyyx(yx)xyxyyyx = xxxyyx(xy)xyxyyyx
xxxyyx(yxxy)xyyyx = xxxyyx(xyyx)xyyyx
xxxyyx(yx)xyyxxyy = xxxyyx(xy)xyyxxyy
xxxyyx(yxxy)yxxyy = xxxyyx(xyyx)yxxyy
xxxyyx(yx)xyyxyxy = xxxyyx(xy)xyyxyxy
xxxyyx(yx)xyyxyyx = xxxyyx(xy)xyyxyyx
xxxyyx(yx)xyyyxxy = xxxyyx(xy)xyyyxxy
xxxyyx(yx)xyyyxyx = xxxyyx(xy)xyyyxyx
xxxyyx(yx)xyyyyxx = xxxyyx(xy)xyyyyxx
xxxyyx(yx)yxxxyyy = xxxyyx(xy)yxxxyyy
xxxyyx(yx)yxxyxyy = xxxyyx(xy)yxxyxyy
xxxyyx(yxyx)xyyxy = xxxyyx(xyxy)xyyxy
xxxyyx(yx)yxxyyxy = xxxyyx(xy)yxxyyxy
xxxyyxyx(yx)xyyxy = xxxyyxyx(xy)xyyxy
xxxyyx(yxyx)xyyyx = xxxyyx(xyxy)xyyyx
xxxyyx(yx)yxxyyyx = xxxyyx(xy)yxxyyyx
xxxyyxyx(yx)xyyyx = xxxyyxyx(xy)xyyyx
xxxyyx(yxyx)yxxyy = xxxyyx(xyxy)yxxyy
xxxyyx(yx)yxyxxyy = xxxyyx(xy)yxyxxyy
xxxyyxyx(yx)yxxyy = xxxyyxyx(xy)yxxyy
xxxyyx(yx)yyxxxyy = xxxyyx(xy)yyxxxyy
xxxyyxyyx(yx)xyyx = xxxyyxyyx(xy)xyyx
xxxyyxyyx(yx)yxxy = xxxyyxyyx(xy)yxxy
xxxyyxy(yx)yyxxxy = xxxyyxy(xy)yyxxxy
xxxyyxy(yx)yyxxyx = xxxyyxy(xy)yyxxyx
xxxyyyxx(yx)xyxyy = xxxyyyxx(xy)xyxyy
xxxyyyxx(yx)xyyxy = xxxyyyxx(xy)xyyxy
xxxyyyxx(yx)xyyyx = xxxyyyxx(xy)xyyyx
xxxyyyxx(yx)yxxyy = xxxyyyxx(xy)yxxyy
xxxyyyxxy(yx)xyyx = xxxyyyxxy(xy)xyyx
xxxyyyxxy(yx)yxxy = xxxyyyxxy(xy)yxxy
xxxyyyx(yxx)xyyyx = xxxyyyx(xxy)xyyyx
xxxyyyx(yx)xxyyyx = xxxyyyx(xy)xxyyyx
xxxyyyx(yx)xyxyyx = xxxyyyx(xy)xyxyyx
xxxyyyx(yxxy)xyyx = xxxyyyx(xyyx)xyyx
xxxyyyx(yx)xyyxxy = xxxyyyx(xy)xyyxxy
xxxyyyx(yxxy)yxxy = xxxyyyx(xyyx)yxxy
xxxyyyx(yx)xyyxyx = xxxyyyx(xy)xyyxyx
xxxyyyx(yx)xyyyxx = xxxyyyx(xy)xyyyxx
xxxyyyx(yx)yxxxyy = xxxyyyx(xy)yxxxyy
xxxyyyx(yx)yxxyxy = xxxyyyx(xy)yxxyxy
xxxyyyx(yxyx)xyyx = xxxyyyx(xyxy)xyyx
xxxyyyx(yx)yxxyyx = xxxyyyx(xy)yxxyyx
xxxyyyxyx(yx)xyyx = xxxyyyxyx(xy)xyyx
xxxyyyx(yxyx)yxxy = xxxyyyx(xyxy)yxxy
xxxyyyx(yx)yxyxxy = xxxyyyx(xy)yxyxxy
xxxyyyxyx(yx)yxxy = xxxyyyxyx(xy)yxxy
xxxyyyx(yx)yxyxyx = xxxyyyx(xy)yxyxyx
xxxyyyx(yx)yyxxxy = xxxyyyx(xy)yyxxxy
xxxyyyx(yx)yyxxyx = xxxyyyx(xy)yyxxyx
xxxyyyyxx(yx)xyxy = xxxyyyyxx(xy)xyxy
xxxyyyyxx(yx)xyyx = xxxyyyyxx(xy)xyyx
xxxyyyyxx(yx)yxxy = xxxyyyyxx(xy)yxxy
xxxyyyyx(yx)xyyxx = xxxyyyyx(xy)xyyxx
xxxyyyyx(yx)yxxxy = xxxyyyyx(xy)yxxxy
xxxyyyyx(yx)yxxyx = xxxyyyyx(xy)yxxyx
xxxyyyyx(yx)yxyxx = xxxyyyyx(xy)yxyxx
xxxyyyyyxx(yx)xyx = xxxyyyyyxx(xy)xyx
xxyxxxxyy(yx)yxyy = xxyxxxxyy(xy)yxyy
xxyxxxxyyy(yx)yxy = xxyxxxxyyy(xy)yxy
xxyxxxyxyy(yx)yxy = xxyxxxyxyy(xy)yxy
xxyxxxy(yx)xyyxyy = xxyxxxy(xy)xyyxyy
xxyxxxy(yx)xyyyxy = xxyxxxy(xy)xyyyxy
xxyxxxy(yx)xyyyyx = xxyxxxy(xy)xyyyyx
xxyxxxy(yx)yxxyyy = xxyxxxy(xy)yxxyyy
xxyxxxyy(yx)xyyxy = xxyxxxyy(xy)xyyxy
xxyxxxyy(yx)xyyyx = xxyxxxyy(xy)xyyyx
xxyxxxyy(yx)yxxyy = xxyxxxyy(xy)yxxyy
xxyxxxyy(yx)yxyxy = xxyxxxyy(xy)yxyxy
xxyxxxyy(yx)yxyyx = xxyxxxyy(xy)yxyyx
xxyxxxyy(yx)yyxxy = xxyxxxyy(xy)yyxxy
xxyxxyxxyy(yx)yxy = xxyxxyxxyy(xy)yxy
xxyxxyxy(yx)xyyxy = xxyxxyxy(xy)xyyxy
xxyxxyxy(yx)xyyyx = xxyxxyxy(xy)xyyyx
xxyxxyxy(yx)yxxyy = xxyxxyxy(xy)yxxyy
xxyxxy(yx)xxyyyxy = xxyxxy(xy)xxyyyxy
xxyxxy(yx)xxyyyyx = xxyxxy(xy)xxyyyyx
xxyxxy(yx)xyxyyxy = xxyxxy(xy)xyxyyxy
xxyxxy(yxxy)xyyxy = xxyxxy(xyyx)xyyxy
xxyxxy(yx)xyxyyyx = xxyxxy(xy)xyxyyyx
xxyxxy(yxxy)xyyyx = xxyxxy(xyyx)xyyyx
xxyxxy(yx)xyyxxyy = xxyxxy(xy)xyyxxyy
xxyxxy(yxxy)yxxyy = xxyxxy(xyyx)yxxyy
xxyxxy(yx)xyyxyxy = xxyxxy(xy)xyyxyxy
xxyxxy(yx)xyyxyyx = xxyxxy(xy)xyyxyyx
xxyxxy(yx)xyyyxxy = xxyxxy(xy)xyyyxxy
xxyxxy(yx)xyyyxyx = xxyxxy(xy)xyyyxyx
xxyxxy(yx)xyyyyxx = xxyxxy(xy)xyyyyxx
xxyxxy(yx)yxxxyyy = xxyxxy(xy)yxxxyyy
xxyxxy(yx)yxxyxyy = xxyxxy(xy)yxxyxyy
xxyxxy(yxyx)xyyxy = xxyxxy(xyxy)xyyxy
xxyxxy(yx)yxxyyxy = xxyxxy(xy)yxxyyxy
xxyxxyyx(yx)xyyxy = xxyxxyyx(xy)xyyxy
xxyxxy(yxyx)xyyyx = xxyxxy(xyxy)xyyyx
xxyxxy(yx)yxxyyyx = xxyxxy(xy)yxxyyyx
xxyxxyyx(yx)xyyyx = xxyxxyyx(xy)xyyyx
xxyxxy(yxyx)yxxyy = xxyxxy(xyxy)yxxyy
xxyxxy(yx)yxyxxyy = xxyxxy(xy)yxyxxyy
xxyxxyyx(yx)yxxyy = xxyxxyyx(xy)yxxyy
xxyxxy(yx)yyxxxyy = xxyxxy(xy)yyxxxyy
xxyxxyy(yx)xyyyxx = xxyxxyy(xy)xyyyxx
xxyxxyyyx(yx)xyyx = xxyxxyyyx(xy)xyyx
xxyxxyyyx(yx)yxxy = xxyxxyyyx(xy)yxxy
xxyxxyy(yx)yxyyxx = xxyxxyy(xy)yxyyxx
xxyxxyy(yx)yyxxxy = xxyxxyy(xy)yyxxxy
xxyxxyy(yx)yyxxyx = xxyxxyy(xy)yyxxyx
xxyx(yx)xxxyyyxyy = xxyx(xy)xxxyyyxyy
xxyx(yx)xxxyyyyxy = xxyx(xy)xxxyyyyxy
xxyx(yx)xxxyyyyyx = xxyx(xy)xxxyyyyyx
xxyx(yx)xxyxyyxyy = xxyx(xy)xxyxyyxyy
xxyx(yx)xxyxyyyxy = xxyx(xy)xxyxyyyxy
xxyx(yx)xxyxyyyyx = xxyx(xy)xxyxyyyyx
xxyx(yx)xxyyxxyyy = xxyx(xy)xxyyxxyyy
xxyx(yx)xxyyxyxyy = xxyx(xy)xxyyxyxyy
xxyx(yx)xxyyxyyxy = xxyx(xy)xxyyxyyxy
xxyx(yxxxyyxy)yxy = xxyx(xyxxyyyx)yxy
xxyx(yx)xxyyxyyyx = xxyx(xy)xxyyxyyyx
xxyx(yx)xxyyyxxyy = xxyx(xy)xxyyyxxyy
xxyx(yxxxyyyx)yxy = xxyx(xyxxyyxy)yxy
xxyx(yx)xxyyyxyxy = xxyx(xy)xxyyyxyxy
xxyxyxxxyy(yx)yxy = xxyxyxxxyy(xy)yxy
xxyx(yx)xxyyyxyyx = xxyx(xy)xxyyyxyyx
xxyx(yx)xxyyyyxxy = xxyx(xy)xxyyyyxxy
xxyx(yx)xxyyyyxyx = xxyx(xy)xxyyyyxyx
xxyx(yx)xxyyyyyxx = xxyx(xy)xxyyyyyxx
xxyxyxxy(yx)xyyxy = xxyxyxxy(xy)xyyxy
xxyxyxxy(yx)xyyyx = xxyxyxxy(xy)xyyyx
xxyxyxxy(yx)yxxyy = xxyxyxxy(xy)yxxyy
xxyx(yx)yxxxxyyyy = xxyx(xy)yxxxxyyyy
xxyxyx(yx)xxyyyxy = xxyxyx(xy)xxyyyxy
xxyxyx(yx)xxyyyyx = xxyxyx(xy)xxyyyyx
xxyxyx(yx)yxxxyyy = xxyxyx(xy)yxxxyyy
xxyxyxy(yx)xyyyxx = xxyxyxy(xy)xyyyxx
xxyxyxyyx(yx)xyyx = xxyxyxyyx(xy)xyyx
xxyxyxyyx(yx)yxxy = xxyxyxyyx(xy)yxxy
xxyxyxy(yx)yyxxxy = xxyxyxy(xy)yyxxxy
xxyxyyxxy(yx)xyyx = xxyxyyxxy(xy)xyyx
xxyxyyxxy(yx)yxxy = xxyxyyxxy(xy)yxxy
xxyxy(yx)xyyyyxxx = xxyxy(xy)xyyyyxxx
xxyxyyx(yx)xxyyyx = xxyxyyx(xy)xxyyyx
xxyxyyx(yx)xyxyyx = xxyxyyx(xy)xyxyyx
xxyxyyx(yxxy)xyyx = xxyxyyx(xyyx)xyyx
xxyxyyx(yx)xyyxxy = xxyxyyx(xy)xyyxxy
xxyxyyx(yxxy)yxxy = xxyxyyx(xyyx)yxxy
xxyxyyx(yx)xyyxyx = xxyxyyx(xy)xyyxyx
xxyxyyx(yx)xyyyxx = xxyxyyx(xy)xyyyxx
xxyxyyx(yx)yxxxyy = xxyxyyx(xy)yxxxyy
xxyxyyx(yx)yxxyxy = xxyxyyx(xy)yxxyxy
xxyxyyx(yxyx)xyyx = xxyxyyx(xyxy)xyyx
xxyxyyx(yx)yxxyyx = xxyxyyx(xy)yxxyyx
xxyxyyxyx(yx)xyyx = xxyxyyxyx(xy)xyyx
xxyxyyx(yxyx)yxxy = xxyxyyx(xyxy)yxxy
xxyxyyx(yx)yxyxxy = xxyxyyx(xy)yxyxxy
xxyxyyxyx(yx)yxxy = xxyxyyxyx(xy)yxxy
xxyxyyx(yx)yyxxxy = xxyxyyx(xy)yyxxxy
xxyxy(yx)yyxxxxyy = xxyxy(xy)yyxxxxyy
xxyxy(yx)yyxxxyxy = xxyxy(xy)yyxxxyxy
xxyxy(yx)yyxxxyyx = xxyxy(xy)yyxxxyyx
xxyxy(yx)yyxxyxxy = xxyxy(xy)yyxxyxxy
xxyxy(yx)yyxyxxxy = xxyxy(xy)yyxyxxxy
xxyxy(yx)yyyxxxxy = xxyxy(xy)yyyxxxxy
xxyxyyyxx(yx)xyxy = xxyxyyyxx(xy)xyxy
xxyxyyyxx(yx)xyyx = xxyxyyyxx(xy)xyyx
xxyxyyyxx(yx)yxxy = xxyxyyyxx(xy)yxxy
xxyxyyyx(yx)xyyxx = xxyxyyyx(xy)xyyxx
xxyxyyyx(yx)yxxxy = xxyxyyyx(xy)yxxxy
xxyxyyyx(yx)yxxyx = xxyxyyyx(xy)yxxyx
xxyxyyyyxx(yx)xyx = xxyxyyyyxx(xy)xyx
xxyyxxxxyy(yx)yxy = xxyyxxxxyy(xy)yxy
xxyyxxxy(yx)xyyxy = xxyyxxxy(xy)xyyxy
xxyyxxxy(yx)xyyyx = xxyyxxxy(xy)xyyyx
xxyyxxxy(yx)yxxyy = xxyyxxxy(xy)yxxyy
xxyyxxxyy(yx)xyyx = xxyyxxxyy(xy)xyyx
xxyyxxxyy(yx)yxxy = xxyyxxxyy(xy)yxxy
xxyyxxxyy(yx)yxyx = xxyyxxxyy(xy)yxyx
xxyyxx(yx)xxyyxyy = xxyyxx(xy)xxyyxyy
xxyyxx(yx)xxyyyxy = xxyyxx(xy)xxyyyxy
xxyyxx(yx)xxyyyyx = xxyyxx(xy)xxyyyyx
xxyyxx(yx)xyxxyyy = xxyyxx(xy)xyxxyyy
xxyyxx(yx)yxxxyyy = xxyyxx(xy)yxxxyyy
xxyyxxyxy(yx)xyyx = xxyyxxyxy(xy)xyyx
xxyyxxyxy(yx)yxxy = xxyyxxyxy(xy)yxxy
xxyyxxy(yx)xxyyyx = xxyyxxy(xy)xxyyyx
xxyyxxy(yx)xyxyyx = xxyyxxy(xy)xyxyyx
xxyyxxy(yxxy)xyyx = xxyyxxy(xyyx)xyyx
xxyyxxy(yx)xyyxxy = xxyyxxy(xy)xyyxxy
xxyyxxy(yxxy)yxxy = xxyyxxy(xyyx)yxxy
xxyyxxy(yx)xyyxyx = xxyyxxy(xy)xyyxyx
xxyyxxy(yx)xyyyxx = xxyyxxy(xy)xyyyxx
xxyyxxy(yx)yxxxyy = xxyyxxy(xy)yxxxyy
xxyyxxy(yx)yxxyxy = xxyyxxy(xy)yxxyxy
xxyyxxy(yxyx)xyyx = xxyyxxy(xyxy)xyyx
xxyyxxy(yx)yxxyyx = xxyyxxy(xy)yxxyyx
xxyyxxyyx(yx)xyyx = xxyyxxyyx(xy)xyyx
xxyyxxy(yxyx)yxxy = xxyyxxy(xyxy)yxxy
xxyyxxy(yx)yxyxxy = xxyyxxy(xy)yxyxxy
xxyyxxyyx(yx)yxxy = xxyyxxyyx(xy)yxxy
xxyyxxy(yx)yyxxxy = xxyyxxy(xy)yyxxxy
xxyyx(yxx)xxyyyyx = xxyyx(xxy)xxyyyyx
xxyyx(yx)xxxyyyyx = xxyyx(xy)xxxyyyyx
xxyyx(yx)xxyxyyyx = xxyyx(xy)xxyxyyyx
xxyyx(yx)xxyyxyyx = xxyyx(xy)xxyyxyyx
xxyyx(yx)xxyyyxxy = xxyyx(xy)xxyyyxxy
xxyyx(yx)xxyyyxyx = xxyyx(xy)xxyyyxyx
xxyyx(yx)xxyyyyxx = xxyyx(xy)xxyyyyxx
xxyyx(yx)xyxxyyyx = xxyyx(xy)xyxxyyyx
xxyyx(yxxy)xxyyyx = xxyyx(xyyx)xxyyyx
xxyyx(yx)xyxyxyyx = xxyyx(xy)xyxyxyyx
xxyyx(yxxyxy)xyyx = xxyyx(xyxyyx)xyyx
xxyyx(yxxy)xyxyyx = xxyyx(xyyx)xyxyyx
xxyyx(yxxyxy)xyyx = xxyyx(xyyxyx)xyyx
xxyyx(yx)xyxyyxxy = xxyyx(xy)xyxyyxxy
xxyyx(yxxyxy)yxxy = xxyyx(xyxyyx)yxxy
xxyyx(yxxy)xyyxxy = xxyyx(xyyx)xyyxxy
xxyyx(yxxyxy)yxxy = xxyyx(xyyxyx)yxxy
xxyyx(yx)xyxyyxyx = xxyyx(xy)xyxyyxyx
xxyyx(yxxy)xyyxyx = xxyyx(xyyx)xyyxyx
xxyyx(yx)xyxyyyxx = xxyyx(xy)xyxyyyxx
xxyyx(yxxy)xyyyxx = xxyyx(xyyx)xyyyxx
xxyyx(yx)xyyxxxyy = xxyyx(xy)xyyxxxyy
xxyyx(yxxy)yxxxyy = xxyyx(xyyx)yxxxyy
xxyyx(yx)xyyxxyxy = xxyyx(xy)xyyxxyxy
xxyyx(yxxy)yxxyxy = xxyyx(xyyx)yxxyxy
xxyyx(yxxyyx)xyyx = xxyyx(xyxyxy)xyyx
xxyyx(yx)xyyxxyyx = xxyyx(xy)xyyxxyyx
xxyyx(yxxyyx)xyyx = xxyyx(xyyxxy)xyyx
xxyyx(yxxy)yxxyyx = xxyyx(xyyx)yxxyyx
xxyyxyxxy(yx)xyyx = xxyyxyxxy(xy)xyyx
xxyyx(yxxyyx)yxxy = xxyyx(xyxyxy)yxxy
xxyyx(yx)xyyxyxxy = xxyyx(xy)xyyxyxxy
xxyyx(yxxyyx)yxxy = xxyyx(xyyxxy)yxxy
xxyyx(yxxy)yxyxxy = xxyyx(xyyx)yxyxxy
xxyyxyxxy(yx)yxxy = xxyyxyxxy(xy)yxxy
xxyyx(yx)xyyxyxyx = xxyyx(xy)xyyxyxyx
xxyyx(yx)xyyxyyxx = xxyyx(xy)xyyxyyxx
xxyyx(yx)xyyyxxxy = xxyyx(xy)xyyyxxxy
xxyyx(yxxy)yyxxxy = xxyyx(xyyx)yyxxxy
xxyyx(yx)xyyyxxyx = xxyyx(xy)xyyyxxyx
xxyyx(yx)xyyyxyxx = xxyyx(xy)xyyyxyxx
xxyyx(yx)xyyyyxxx = xxyyx(xy)xyyyyxxx
xxyyx(yx)yxxxxyyy = xxyyx(xy)yxxxxyyy
xxyyx(yx)yxxxyxyy = xxyyx(xy)yxxxyxyy
xxyyx(yx)yxxxyyxy = xxyyx(xy)yxxxyyxy
xxyyx(yxyx)xxyyyx = xxyyx(xyxy)xxyyyx
xxyyx(yx)yxxxyyyx = xxyyx(xy)yxxxyyyx
xxyyxyx(yx)xxyyyx = xxyyxyx(xy)xxyyyx
xxyyx(yx)yxxyxxyy = xxyyx(xy)yxxyxxyy
xxyyx(yx)yxxyxyxy = xxyyx(xy)yxxyxyxy
xxyyx(yxyx)xyxyyx = xxyyx(xyxy)xyxyyx
xxyyx(yxyxxy)xyyx = xxyyx(xyxyyx)xyyx
xxyyx(yx)yxxyxyyx = xxyyx(xy)yxxyxyyx
xxyyx(yxyxxy)xyyx = xxyyx(xyyxyx)xyyx
xxyyxyx(yx)xyxyyx = xxyyxyx(xy)xyxyyx
xxyyxyx(yxxy)xyyx = xxyyxyx(xyyx)xyyx
xxyyx(yxyx)xyyxxy = xxyyx(xyxy)xyyxxy
xxyyx(yxyxxy)yxxy = xxyyx(xyxyyx)yxxy
xxyyx(yx)yxxyyxxy = xxyyx(xy)yxxyyxxy
xxyyx(yxyxxy)yxxy = xxyyx(xyyxyx)yxxy
xxyyxyx(yx)xyyxxy = xxyyxyx(xy)xyyxxy
xxyyxyx(yxxy)yxxy = xxyyxyx(xyyx)yxxy
xxyyx(yxyx)xyyxyx = xxyyx(xyxy)xyyxyx
xxyyx(yx)yxxyyxyx = xxyyx(xy)yxxyyxyx
xxyyxyx(yx)xyyxyx = xxyyxyx(xy)xyyxyx
xxyyx(yxyx)xyyyxx = xxyyx(xyxy)xyyyxx
xxyyx(yx)yxxyyyxx = xxyyx(xy)yxxyyyxx
xxyyxyx(yx)xyyyxx = xxyyxyx(xy)xyyyxx
xxyyx(yxyx)yxxxyy = xxyyx(xyxy)yxxxyy
xxyyx(yx)yxyxxxyy = xxyyx(xy)yxyxxxyy
xxyyxyx(yx)yxxxyy = xxyyxyx(xy)yxxxyy
xxyyx(yxyx)yxxyxy = xxyyx(xyxy)yxxyxy
xxyyx(yx)yxyxxyxy = xxyyx(xy)yxyxxyxy
xxyyxyx(yx)yxxyxy = xxyyxyx(xy)yxxyxy
xxyyx(yxyxyx)xyyx = xxyyx(xyxyxy)xyyx
xxyyx(yxyx)yxxyyx = xxyyx(xyxy)yxxyyx
xxyyx(yxyxyx)xyyx = xxyyx(xyyxxy)xyyx
xxyyx(yx)yxyxxyyx = xxyyx(xy)yxyxxyyx
xxyyxyx(yxyx)xyyx = xxyyxyx(xyxy)xyyx
xxyyxyx(yx)yxxyyx = xxyyxyx(xy)yxxyyx
xxyyxyxyx(yx)xyyx = xxyyxyxyx(xy)xyyx
xxyyx(yxyxyx)yxxy = xxyyx(xyxyxy)yxxy
xxyyx(yxyx)yxyxxy = xxyyx(xyxy)yxyxxy
xxyyx(yxyxyx)yxxy = xxyyx(xyyxxy)yxxy
xxyyx(yx)yxyxyxxy = xxyyx(xy)yxyxyxxy
xxyyxyx(yxyx)yxxy = xxyyxyx(xyxy)yxxy
xxyyxyx(yx)yxyxxy = xxyyxyx(xy)yxyxxy
xxyyxyxyx(yx)yxxy = xxyyxyxyx(xy)yxxy
xxyyx(yxyx)yyxxxy = xxyyx(xyxy)yyxxxy
xxyyx(yx)yxyyxxxy = xxyyx(xy)yxyyxxxy
xxyyxyx(yx)yyxxxy = xxyyxyx(xy)yyxxxy
xxyyx(yx)yyxxxxyy = xxyyx(xy)yyxxxxyy
xxyyx(yx)yyxxxyxy = xxyyx(xy)yyxxxyxy
xxyyx(yx)yyxxxyyx = xxyyx(xy)yyxxxyyx
xxyyx(yx)yyxxyxxy = xxyyx(xy)yyxxyxxy
xxyyx(yx)yyxyxxxy = xxyyx(xy)yyxyxxxy
xxyyx(yx)yyyxxxxy = xxyyx(xy)yyyxxxxy
xxyyxyyxx(yx)xyxy = xxyyxyyxx(xy)xyxy
xxyyxyyxx(yx)xyyx = xxyyxyyxx(xy)xyyx
xxyyxyyxx(yx)yxxy = xxyyxyyxx(xy)yxxy
xxyyxyyx(yx)xyyxx = xxyyxyyx(xy)xyyxx
xxyyxyyx(yx)yxxxy = xxyyxyyx(xy)yxxxy
xxyyxyyx(yx)yxxyx = xxyyxyyx(xy)yxxyx
xxyyx(yyx)yyxxxxy = xxyyx(xyy)yyxxxxy
xxyyxy(yx)yyxxxxy = xxyyxy(xy)yyxxxxy
xxyyxy(yx)yyxxxyx = xxyyxy(xy)yyxxxyx
xxyyxy(yx)yyxxyxx = xxyyxy(xy)yyxxyxx
xxyyxyyyxx(yx)xyx = xxyyxyyyxx(xy)xyx
xxyyyxxxy(yx)xyyx = xxyyyxxxy(xy)xyyx
xxyyyxxxy(yx)yxxy = xxyyyxxxy(xy)yxxy
xxyyyxx(yx)xxyyxy = xxyyyxx(xy)xxyyxy
xxyyyxx(yx)xxyyyx = xxyyyxx(xy)xxyyyx
xxyyyxx(yx)xyxxyy = xxyyyxx(xy)xyxxyy
xxyyyxx(yx)xyxyxy = xxyyyxx(xy)xyxyxy
xxyyyxx(yx)xyxyyx = xxyyyxx(xy)xyxyyx
xxyyyxx(yxxy)xyyx = xxyyyxx(xyyx)xyyx
xxyyyxx(yx)xyyxxy = xxyyyxx(xy)xyyxxy
xxyyyxx(yxxy)yxxy = xxyyyxx(xyyx)yxxy
xxyyyxx(yx)xyyxyx = xxyyyxx(xy)xyyxyx
xxyyyxx(yx)xyyyxx = xxyyyxx(xy)xyyyxx
xxyyyxx(yx)yxxxyy = xxyyyxx(xy)yxxxyy
xxyyyxx(yx)yxxyxy = xxyyyxx(xy)yxxyxy
xxyyyxx(yxyx)xyyx = xxyyyxx(xyxy)xyyx
xxyyyxx(yx)yxxyyx = xxyyyxx(xy)yxxyyx
xxyyyxxyx(yx)xyyx = xxyyyxxyx(xy)xyyx
xxyyyxx(yxyx)yxxy = xxyyyxx(xyxy)yxxy
xxyyyxx(yx)yxyxxy = xxyyyxx(xy)yxyxxy
xxyyyxxyx(yx)yxxy = xxyyyxxyx(xy)yxxy
xxyyyxx(yx)yyxxxy = xxyyyxx(xy)yyxxxy
xxyyyxxy(yx)xyyxx = xxyyyxxy(xy)xyyxx
xxyyyxx(yyx)yxxxy = xxyyyxx(xyy)yxxxy
xxyyyxxy(yx)yxxxy = xxyyyxxy(xy)yxxxy
xxyyyxxy(yx)yxxyx = xxyyyxxy(xy)yxxyx
xxyyyx(yxx)xyyyxx = xxyyyx(xxy)xyyyxx
xxyyyx(yx)xxyyyxx = xxyyyx(xy)xxyyyxx
xxyyyxyxx(yx)xyxy = xxyyyxyxx(xy)xyxy
xxyyyxyxx(yx)xyyx = xxyyyxyxx(xy)xyyx
xxyyyxyxx(yx)yxxy = xxyyyxyxx(xy)yxxy
xxyyyx(yx)xyxyyxx = xxyyyx(xy)xyxyyxx
xxyyyx(yxxy)xyyxx = xxyyyx(xyyx)xyyxx
xxyyyx(yxx)yyxxxy = xxyyyx(xxy)yyxxxy
xxyyyx(yx)xyyxxxy = xxyyyx(xy)xyyxxxy
xxyyyx(yxxy)yxxxy = xxyyyx(xyyx)yxxxy
xxyyyx(yx)xyyxxyx = xxyyyx(xy)xyyxxyx
xxyyyx(yxxy)yxxyx = xxyyyx(xyyx)yxxyx
xxyyyx(yx)xyyxyxx = xxyyyx(xy)xyyxyxx
xxyyyx(yx)xyyyxxx = xxyyyx(xy)xyyyxxx
xxyyyx(yx)yxxxxyy = xxyyyx(xy)yxxxxyy
xxyyyx(yx)yxxxyxy = xxyyyx(xy)yxxxyxy
xxyyyx(yx)yxxxyyx = xxyyyx(xy)yxxxyyx
xxyyyx(yx)yxxyxxy = xxyyyx(xy)yxxyxxy
xxyyyx(yx)yxxyxyx = xxyyyx(xy)yxxyxyx
xxyyyx(yxyx)xyyxx = xxyyyx(xyxy)xyyxx
xxyyyx(yx)yxxyyxx = xxyyyx(xy)yxxyyxx
xxyyyxyx(yx)xyyxx = xxyyyxyx(xy)xyyxx
xxyyyx(yxyx)yxxxy = xxyyyx(xxyy)yxxxy
xxyyyx(yxyx)yxxxy = xxyyyx(xyxy)yxxxy
xxyyyx(yx)yxyxxxy = xxyyyx(xy)yxyxxxy
xxyyyxyx(yx)yxxxy = xxyyyxyx(xy)yxxxy
xxyyyx(yxyx)yxxyx = xxyyyx(xyxy)yxxyx
xxyyyx(yx)yxyxxyx = xxyyyx(xy)yxyxxyx
xxyyyxyx(yx)yxxyx = xxyyyxyx(xy)yxxyx
xxyyyx(yx)yxyxyxx = xxyyyx(xy)yxyxyxx
xxyyyx(yx)yyxxxxy = xxyyyx(xy)yyxxxxy
xxyyyx(yx)yyxxxyx = xxyyyx(xy)yyxxxyx
xxyyyx(yx)yyxxyxx = xxyyyx(xy)yyxxyxx
xxyyyxyyxx(yx)xyx = xxyyyxyyxx(xy)xyx
xxyyyyxxx(yx)xyxy = xxyyyyxxx(xy)xyxy
xxyyyyxxx(yx)xyyx = xxyyyyxxx(xy)xyyx
xxyyyyxxx(yx)yxxy = xxyyyyxxx(xy)yxxy
xxyyyyxx(yxx)xyyx = xxyyyyxx(xxy)xyyx
xxyyyyxx(yx)xxyyx = xxyyyyxx(xy)xxyyx
xxyyyyxx(yxx)yxxy = xxyyyyxx(xxy)yxxy
xxyyyyxx(yx)xyxxy = xxyyyyxx(xy)xyxxy
xxyyyyxx(yx)xyxyx = xxyyyyxx(xy)xyxyx
xxyyyyxx(yx)xyyxx = xxyyyyxx(xy)xyyxx
xxyyyyxx(yx)yxxxy = xxyyyyxx(xy)yxxxy
xxyyyyxx(yx)yxxyx = xxyyyyxx(xy)yxxyx
xxyyyyxyxx(yx)xyx = xxyyyyxyxx(xy)xyx
xxyyyyx(yx)xyyxxx = xxyyyyx(xy)xyyxxx
xxyyyyx(yx)yxxxxy = xxyyyyx(xy)yxxxxy
xxyyyyx(yx)yxxxyx = xxyyyyx(xy)yxxxyx
xxyyyyx(yx)yxxyxx = xxyyyyx(xy)yxxyxx
xxyyyyx(yx)yxyxxx = xxyyyyx(xy)yxyxxx
xxyyyyyxxx(yx)xyx = xxyyyyyxxx(xy)xyx
xxyyyyyxx(yx)xyxx = xxyyyyyxx(xy)xyxx
xyxxxxxyy(yx)yxyy = xyxxxxxyy(xy)yxyy
xyxxxxxyyy(yx)yxy = xyxxxxxyyy(xy)yxy
xyxxxxyxyy(yx)yxy = xyxxxxyxyy(xy)yxy
xyxxxxy(yx)xyxyyy = xyxxxxy(xy)xyxyyy
xyxxxxy(yx)xyyxyy = xyxxxxy(xy)xyyxyy
xyxxxxy(yx)xyyyxy = xyxxxxy(xy)xyyyxy
xyxxxxy(yx)xyyyyx = xyxxxxy(xy)xyyyyx
xyxxxxy(yx)yxxyyy = xyxxxxy(xy)yxxyyy
xyxxxxyy(yx)xyyxy = xyxxxxyy(xy)xyyxy
xyxxxxyy(yx)xyyyx = xyxxxxyy(xy)xyyyx
xyxxxxyy(yx)yxxyy = xyxxxxyy(xy)yxxyy
xyxxxxyy(yx)yxyxy = xyxxxxyy(xy)yxyxy
xyxxxxyy(yx)yxyyx = xyxxxxyy(xy)yxyyx
xyxxxxyy(yx)yyxxy = xyxxxxyy(xy)yyxxy
xyxxxxyy(yyx)xyyx = xyxxxxyy(xyy)xyyx
xyxxxxyyy(yx)xyyx = xyxxxxyyy(xy)xyyx
xyxxxxyy(yyx)yxxy = xyxxxxyy(xyy)yxxy
xyxxxxyyy(yx)yxxy = xyxxxxyyy(xy)yxxy
xyxxxxyyy(yx)yxyx = xyxxxxyyy(xy)yxyx
xyxxxyxxyy(yx)yxy = xyxxxyxxyy(xy)yxy
xyxxxyxy(yx)xyyxy = xyxxxyxy(xy)xyyxy
xyxxxyxy(yx)xyyyx = xyxxxyxy(xy)xyyyx
xyxxxyxy(yx)yxxyy = xyxxxyxy(xy)yxxyy
xyxxxyxyy(yx)xyyx = xyxxxyxyy(xy)xyyx
xyxxxyxyy(yx)yxxy = xyxxxyxyy(xy)yxxy
xyxxxyxyy(yx)yxyx = xyxxxyxyy(xy)yxyx
xyxxxy(yx)xxyyxyy = xyxxxy(xy)xxyyxyy
xyxxxy(yx)xxyyyxy = xyxxxy(xy)xxyyyxy
xyxxxy(yx)xxyyyyx = xyxxxy(xy)xxyyyyx
xyxxxy(yx)xyxyxyy = xyxxxy(xy)xyxyxyy
xyxxxy(yx)xyxyyxy = xyxxxy(xy)xyxyyxy
xyxxxy(yxxy)xyyxy = xyxxxy(xyyx)xyyxy
xyxxxy(yx)xyxyyyx = xyxxxy(xy)xyxyyyx
xyxxxy(yxxy)xyyyx = xyxxxy(xyyx)xyyyx
xyxxxy(yx)xyyxxyy = xyxxxy(xy)xyyxxyy
xyxxxy(yxxy)yxxyy = xyxxxy(xyyx)yxxyy
xyxxxy(yx)xyyxyxy = xyxxxy(xy)xyyxyxy
xyxxxy(yx)xyyxyyx = xyxxxy(xy)xyyxyyx
xyxxxy(yx)xyyyxxy = xyxxxy(xy)xyyyxxy
xyxxxy(yx)xyyyxyx = xyxxxy(xy)xyyyxyx
xyxxxy(yx)xyyyyxx = xyxxxy(xy)xyyyyxx
xyxxxy(yx)yxxxyyy = xyxxxy(xy)yxxxyyy
xyxxxy(yx)yxxyxyy = xyxxxy(xy)yxxyxyy
xyxxxy(yxyx)xyyxy = xyxxxy(xyxy)xyyxy
xyxxxy(yx)yxxyyxy = xyxxxy(xy)yxxyyxy
xyxxxyyx(yx)xyyxy = xyxxxyyx(xy)xyyxy
xyxxxy(yxyx)xyyyx = xyxxxy(xyxy)xyyyx
xyxxxy(yx)yxxyyyx = xyxxxy(xy)yxxyyyx
xyxxxyyx(yx)xyyyx = xyxxxyyx(xy)xyyyx
xyxxxy(yxyx)yxxyy = xyxxxy(xyxy)yxxyy
xyxxxy(yx)yxyxxyy = xyxxxy(xy)yxyxxyy
xyxxxyyx(yx)yxxyy = xyxxxyyx(xy)yxxyy
xyxxxy(yx)yyxxxyy = xyxxxy(xy)yyxxxyy
xyxxxyyxy(yx)xyyx = xyxxxyyxy(xy)xyyx
xyxxxyyxy(yx)yxxy = xyxxxyyxy(xy)yxxy
xyxxxy(yyxx)xyyyx = xyxxxy(xyxy)xyyyx
xyxxxy(yyx)xxyyyx = xyxxxy(xyy)xxyyyx
xyxxxyy(yxx)xyyyx = xyxxxyy(xxy)xyyyx
xyxxxyy(yx)xxyyyx = xyxxxyy(xy)xxyyyx
xyxxxyy(yx)xyxyyx = xyxxxyy(xy)xyxyyx
xyxxxyy(yxxy)xyyx = xyxxxyy(xyyx)xyyx
xyxxxyy(yx)xyyxxy = xyxxxyy(xy)xyyxxy
xyxxxyy(yxxy)yxxy = xyxxxyy(xyyx)yxxy
xyxxxyy(yx)xyyxyx = xyxxxyy(xy)xyyxyx
xyxxxyy(yx)xyyyxx = xyxxxyy(xy)xyyyxx
xyxxxy(yyx)yxxxyy = xyxxxy(xyy)yxxxyy
xyxxxyy(yx)yxxxyy = xyxxxyy(xy)yxxxyy
xyxxxyy(yx)yxxyxy = xyxxxyy(xy)yxxyxy
xyxxxyy(yxyx)xyyx = xyxxxyy(xyxy)xyyx
xyxxxyy(yx)yxxyyx = xyxxxyy(xy)yxxyyx
xyxxxyyyx(yx)xyyx = xyxxxyyyx(xy)xyyx
xyxxxyy(yxyx)yxxy = xyxxxyy(xyxy)yxxy
xyxxxyy(yx)yxyxxy = xyxxxyy(xy)yxyxxy
xyxxxyyyx(yx)yxxy = xyxxxyyyx(xy)yxxy
xyxxxyy(yx)yxyxyx = xyxxxyy(xy)yxyxyx
xyxxxyy(yx)yxyyxx = xyxxxyy(xy)yxyyxx
xyxxxyy(yx)yyxxxy = xyxxxyy(xy)yyxxxy
xyxxxyy(yx)yyxxyx = xyxxxyy(xy)yyxxyx
xyxx(yx)xxxyyxyyy = xyxx(xy)xxxyyxyyy
xyxx(yx)xxxyyyxyy = xyxx(xy)xxxyyyxyy
xyxx(yx)xxxyyyyxy = xyxx(xy)xxxyyyyxy
xyxx(yx)xxxyyyyyx = xyxx(xy)xxxyyyyyx
xyxxyxxxyy(yx)yxy = xyxxyxxxyy(xy)yxy
xyxxyxxy(yx)xyyxy = xyxxyxxy(xy)xyyxy
xyxxyxxy(yx)xyyyx = xyxxyxxy(xy)xyyyx
xyxxyxxy(yx)yxxyy = xyxxyxxy(xy)yxxyy
xyxxyxxyy(yx)xyyx = xyxxyxxyy(xy)xyyx
xyxxyxxyy(yx)yxxy = xyxxyxxyy(xy)yxxy
xyxxyxxyy(yx)yxyx = xyxxyxxyy(xy)yxyx
xyxxyx(yx)xxyyxyy = xyxxyx(xy)xxyyxyy
xyxxyx(yx)xxyyyxy = xyxxyx(xy)xxyyyxy
xyxxyx(yx)xxyyyyx = xyxxyx(xy)xxyyyyx
xyxxyxyxy(yx)xyyx = xyxxyxyxy(xy)xyyx
xyxxyxyxy(yx)yxxy = xyxxyxyxy(xy)yxxy
xyxxyxy(yx)xxyyyx = xyxxyxy(xy)xxyyyx
xyxxyxy(yx)xyxyyx = xyxxyxy(xy)xyxyyx
xyxxyxy(yxxy)xyyx = xyxxyxy(xyyx)xyyx
xyxxyxy(yx)xyyxxy = xyxxyxy(xy)xyyxxy
xyxxyxy(yxxy)yxxy = xyxxyxy(xyyx)yxxy
xyxxyxy(yx)xyyxyx = xyxxyxy(xy)xyyxyx
xyxxyxy(yx)xyyyxx = xyxxyxy(xy)xyyyxx
xyxxyxy(yx)yxxxyy = xyxxyxy(xy)yxxxyy
xyxxyxy(yx)yxxyxy = xyxxyxy(xy)yxxyxy
xyxxyxy(yxyx)xyyx = xyxxyxy(xyxy)xyyx
xyxxyxy(yx)yxxyyx = xyxxyxy(xy)yxxyyx
xyxxyxyyx(yx)xyyx = xyxxyxyyx(xy)xyyx
xyxxyxy(yxyx)yxxy = xyxxyxy(xyxy)yxxy
xyxxyxy(yx)yxyxxy = xyxxyxy(xy)yxyxxy
xyxxyxyyx(yx)yxxy = xyxxyxyyx(xy)yxxy
xyxxyxy(yx)yyxxxy = xyxxyxy(xy)yyxxxy
xyxxy(yxx)xxyyyyx = xyxxy(xxy)xxyyyyx
xyxxy(yx)xxxyyyyx = xyxxy(xy)xxxyyyyx
xyxxy(yx)xxyxyyyx = xyxxy(xy)xxyxyyyx
xyxxy(yx)xxyyxyyx = xyxxy(xy)xxyyxyyx
xyxxy(yx)xxyyyxxy = xyxxy(xy)xxyyyxxy
xyxxy(yx)xxyyyxyx = xyxxy(xy)xxyyyxyx
xyxxy(yx)xxyyyyxx = xyxxy(xy)xxyyyyxx
xyxxy(yx)xyxxyyyx = xyxxy(xy)xyxxyyyx
xyxxy(yxxy)xxyyyx = xyxxy(xyyx)xxyyyx
xyxxy(yx)xyxyxyyx = xyxxy(xy)xyxyxyyx
xyxxy(yxxyxy)xyyx = xyxxy(xyxyyx)xyyx
xyxxy(yxxy)xyxyyx = xyxxy(xyyx)xyxyyx
xyxxy(yxxyxy)xyyx = xyxxy(xyyxyx)xyyx
xyxxy(yx)xyxyyxxy = xyxxy(xy)xyxyyxxy
xyxxy(yxxyxy)yxxy = xyxxy(xyxyyx)yxxy
xyxxy(yxxy)xyyxxy = xyxxy(xyyx)xyyxxy
xyxxy(yxxyxy)yxxy = xyxxy(xyyxyx)yxxy
xyxxy(yx)xyxyyxyx = xyxxy(xy)xyxyyxyx
xyxxy(yxxy)xyyxyx = xyxxy(xyyx)xyyxyx
xyxxy(yx)xyxyyyxx = xyxxy(xy)xyxyyyxx
xyxxy(yxxy)xyyyxx = xyxxy(xyyx)xyyyxx
xyxxy(yx)xyyxxxyy = xyxxy(xy)xyyxxxyy
xyxxy(yxxy)yxxxyy = xyxxy(xyyx)yxxxyy
xyxxy(yx)xyyxxyxy = xyxxy(xy)xyyxxyxy
xyxxy(yxxy)yxxyxy = xyxxy(xyyx)yxxyxy
xyxxy(yxxyyx)xyyx = xyxxy(xyxyxy)xyyx
xyxxy(yx)xyyxxyyx = xyxxy(xy)xyyxxyyx
xyxxy(yxxyyx)xyyx = xyxxy(xyyxxy)xyyx
xyxxy(yxxy)yxxyyx = xyxxy(xyyx)yxxyyx
xyxxyyxxy(yx)xyyx = xyxxyyxxy(xy)xyyx
xyxxy(yxxyyx)yxxy = xyxxy(xyxyxy)yxxy
xyxxy(yx)xyyxyxxy = xyxxy(xy)xyyxyxxy
xyxxy(yxxyyx)yxxy = xyxxy(xyyxxy)yxxy
xyxxy(yxxy)yxyxxy = xyxxy(xyyx)yxyxxy
xyxxyyxxy(yx)yxxy = xyxxyyxxy(xy)yxxy
xyxxy(yx)xyyxyxyx = xyxxy(xy)xyyxyxyx
xyxxy(yx)xyyxyyxx = xyxxy(xy)xyyxyyxx
xyxxy(yx)xyyyxxxy = xyxxy(xy)xyyyxxxy
xyxxy(yxxy)yyxxxy = xyxxy(xyyx)yyxxxy
xyxxy(yx)xyyyxxyx = xyxxy(xy)xyyyxxyx
xyxxy(yx)xyyyxyxx = xyxxy(xy)xyyyxyxx
xyxxy(yx)xyyyyxxx = xyxxy(xy)xyyyyxxx
xyxxy(yx)yxxxxyyy = xyxxy(xy)yxxxxyyy
xyxxy(yx)yxxxyxyy = xyxxy(xy)yxxxyxyy
xyxxy(yx)yxxxyyxy = xyxxy(xy)yxxxyyxy
xyxxy(yxyx)xxyyyx = xyxxy(xyxy)xxyyyx
xyxxy(yx)yxxxyyyx = xyxxy(xy)yxxxyyyx
xyxxyyx(yx)xxyyyx = xyxxyyx(xy)xxyyyx
xyxxy(yx)yxxyxxyy = xyxxy(xy)yxxyxxyy
xyxxy(yx)yxxyxyxy = xyxxy(xy)yxxyxyxy
xyxxy(yxyx)xyxyyx = xyxxy(xyxy)xyxyyx
xyxxy(yxyxxy)xyyx = xyxxy(xyxyyx)xyyx
xyxxy(yx)yxxyxyyx = xyxxy(xy)yxxyxyyx
xyxxy(yxyxxy)xyyx = xyxxy(xyyxyx)xyyx
xyxxyyx(yx)xyxyyx = xyxxyyx(xy)xyxyyx
xyxxyyx(yxxy)xyyx = xyxxyyx(xyyx)xyyx
xyxxy(yxyx)xyyxxy = xyxxy(xyxy)xyyxxy
xyxxy(yxyxxy)yxxy = xyxxy(xyxyyx)yxxy
xyxxy(yx)yxxyyxxy = xyxxy(xy)yxxyyxxy
xyxxy(yxyxxy)yxxy = xyxxy(xyyxyx)yxxy
xyxxyyx(yx)xyyxxy = xyxxyyx(xy)xyyxxy
xyxxyyx(yxxy)yxxy = xyxxyyx(xyyx)yxxy
xyxxy(yxyx)xyyxyx = xyxxy(xyxy)xyyxyx
xyxxy(yx)yxxyyxyx = xyxxy(xy)yxxyyxyx
xyxxyyx(yx)xyyxyx = xyxxyyx(xy)xyyxyx
xyxxy(yxyx)xyyyxx = xyxxy(xyxy)xyyyxx
xyxxy(yx)yxxyyyxx = xyxxy(xy)yxxyyyxx
xyxxyyx(yx)xyyyxx = xyxxyyx(xy)xyyyxx
xyxxy(yxyx)yxxxyy = xyxxy(xyxy)yxxxyy
xyxxy(yx)yxyxxxyy = xyxxy(xy)yxyxxxyy
xyxxyyx(yx)yxxxyy = xyxxyyx(xy)yxxxyy
xyxxy(yxyx)yxxyxy = xyxxy(xyxy)yxxyxy
xyxxy(yx)yxyxxyxy = xyxxy(xy)yxyxxyxy
xyxxyyx(yx)yxxyxy = xyxxyyx(xy)yxxyxy
xyxxy(yxyxyx)xyyx = xyxxy(xyxyxy)xyyx
xyxxy(yxyx)yxxyyx = xyxxy(xyxy)yxxyyx
xyxxy(yxyxyx)xyyx = xyxxy(xyyxxy)xyyx
xyxxy(yx)yxyxxyyx = xyxxy(xy)yxyxxyyx
xyxxyyx(yxyx)xyyx = xyxxyyx(xyxy)xyyx
xyxxyyx(yx)yxxyyx = xyxxyyx(xy)yxxyyx
xyxxyyxyx(yx)xyyx = xyxxyyxyx(xy)xyyx
xyxxy(yxyxyx)yxxy = xyxxy(xyxyxy)yxxy
xyxxy(yxyx)yxyxxy = xyxxy(xyxy)yxyxxy
xyxxy(yxyxyx)yxxy = xyxxy(xyyxxy)yxxy
xyxxy(yx)yxyxyxxy = xyxxy(xy)yxyxyxxy
xyxxyyx(yxyx)yxxy = xyxxyyx(xyxy)yxxy
xyxxyyx(yx)yxyxxy = xyxxyyx(xy)yxyxxy
xyxxyyxyx(yx)yxxy = xyxxyyxyx(xy)yxxy
xyxxy(yxyx)yyxxxy = xyxxy(xyxy)yyxxxy
xyxxy(yx)yxyyxxxy = xyxxy(xy)yxyyxxxy
xyxxyyx(yx)yyxxxy = xyxxyyx(xy)yyxxxy
xyxxy(yx)yyxxxxyy = xyxxy(xy)yyxxxxyy
xyxxy(yx)yyxxxyxy = xyxxy(xy)yyxxxyxy
xyxxy(yx)yyxxxyyx = xyxxy(xy)yyxxxyyx
xyxxy(yx)yyxxyxxy = xyxxy(xy)yyxxyxxy
xyxxy(yx)yyxyxxxy = xyxxy(xy)yyxyxxxy
xyxxy(yx)yyyxxxxy = xyxxy(xy)yyyxxxxy
xyxxyyyxx(yx)xyxy = xyxxyyyxx(xy)xyxy
xyxxyyyxx(yx)xyyx = xyxxyyyxx(xy)xyyx
xyxxyyyxx(yx)yxxy = xyxxyyyxx(xy)yxxy
xyxxyy(yx)xyyyxxx = xyxxyy(xy)xyyyxxx
xyxxyyyx(yx)xyyxx = xyxxyyyx(xy)xyyxx
xyxxyyyx(yx)yxxxy = xyxxyyyx(xy)yxxxy
xyxxyyyx(yx)yxxyx = xyxxyyyx(xy)yxxyx
xyxxyy(yx)yxyyxxx = xyxxyy(xy)yxyyxxx
xyxxy(yyx)yyxxxxy = xyxxy(xyy)yyxxxxy
xyxxyy(yx)yyxxxxy = xyxxyy(xy)yyxxxxy
xyxxyy(yx)yyxxxyx = xyxxyy(xy)yyxxxyx
xyxxyy(yx)yyxxyxx = xyxxyy(xy)yyxxyxx
xyxxyyyyxx(yx)xyx = xyxxyyyyxx(xy)xyx
xyx(yxx)xxxyyyyyx = xyx(xxy)xxxyyyyyx
xyx(yx)xxxxyyyyyx = xyx(xy)xxxxyyyyyx
xyx(yx)xxxyxyyyyx = xyx(xy)xxxyxyyyyx
xyx(yx)xxxyyxyyyx = xyx(xy)xxxyyxyyyx
xyxyxxxxyy(yx)yxy = xyxyxxxxyy(xy)yxy
xyx(yx)xxxyyyxyyx = xyx(xy)xxxyyyxyyx
xyx(yx)xxxyyyyxxy = xyx(xy)xxxyyyyxxy
xyx(yx)xxxyyyyxyx = xyx(xy)xxxyyyyxyx
xyx(yx)xxxyyyyyxx = xyx(xy)xxxyyyyyxx
xyx(yx)xxyxxyyyyx = xyx(xy)xxyxxyyyyx
xyx(yxxxy)xxyyyyx = xyx(xyxyx)xxyyyyx
xyx(yxxxy)xxyyyyx = xyx(xyyxx)xxyyyyx
xyx(yx)xxyxyxyyyx = xyx(xy)xxyxyxyyyx
xyx(yxxxyxy)xyyyx = xyx(xyxxyyx)xyyyx
xyx(yx)xxyxyyxyyx = xyx(xy)xxyxyyxyyx
xyx(yx)xxyxyyyxxy = xyx(xy)xxyxyyyxxy
xyx(yx)xxyxyyyxyx = xyx(xy)xxyxyyyxyx
xyx(yx)xxyxyyyyxx = xyx(xy)xxyxyyyyxx
xyxyxxxy(yx)xyyxy = xyxyxxxy(xy)xyyxy
xyx(yxxxyyx)xyyyx = xyx(xyxxyxy)xyyyx
xyx(yx)xxyyxxyyyx = xyx(xy)xxyyxxyyyx
xyxyxxxy(yx)xyyyx = xyxyxxxy(xy)xyyyx
xyxyxxxy(yx)yxxyy = xyxyxxxy(xy)yxxyy
xyx(yx)xxyyxyxyyx = xyx(xy)xxyyxyxyyx
xyx(yxxxyyxy)xyyx = xyx(xyxxyyyx)xyyx
xyx(yx)xxyyxyyxxy = xyx(xy)xxyyxyyxxy
xyx(yxxxyyxy)yxxy = xyx(xyxxyyyx)yxxy
xyx(yx)xxyyxyyxyx = xyx(xy)xxyyxyyxyx
xyx(yxxxyyxy)yxyx = xyx(xyxxyyyx)yxyx
xyx(yx)xxyyxyyyxx = xyx(xy)xxyyxyyyxx
xyx(yx)xxyyyxxxyy = xyx(xy)xxyyyxxxyy
xyx(yx)xxyyyxxyxy = xyx(xy)xxyyyxxyxy
xyx(yxxxyyyx)xyyx = xyx(xyxxyyxy)xyyx
xyx(yx)xxyyyxxyyx = xyx(xy)xxyyyxxyyx
xyxyxxxyy(yx)xyyx = xyxyxxxyy(xy)xyyx
xyx(yxxxyyyx)yxxy = xyx(xyxxyyxy)yxxy
xyx(yx)xxyyyxyxxy = xyx(xy)xxyyyxyxxy
xyxyxxxyy(yx)yxxy = xyxyxxxyy(xy)yxxy
xyx(yxxxyyyx)yxyx = xyx(xyxxyyxy)yxyx
xyx(yx)xxyyyxyxyx = xyx(xy)xxyyyxyxyx
xyxyxxxyy(yx)yxyx = xyxyxxxyy(xy)yxyx
xyx(yx)xxyyyxyyxx = xyx(xy)xxyyyxyyxx
xyx(yx)xxyyyyxxxy = xyx(xy)xxyyyyxxxy
xyx(yx)xxyyyyxxyx = xyx(xy)xxyyyyxxyx
xyx(yx)xxyyyyxyxx = xyx(xy)xxyyyyxyxx
xyx(yx)xxyyyyyxxx = xyx(xy)xxyyyyyxxx
xyxyxx(yx)xxyyxyy = xyxyxx(xy)xxyyxyy
xyxyxx(yx)xxyyyxy = xyxyxx(xy)xxyyyxy
xyx(yxxyx)xxyyyyx = xyx(xyxxy)xxyyyyx
xyx(yx)xyxxxyyyyx = xyx(xy)xyxxxyyyyx
xyx(yxxy)xxxyyyyx = xyx(xyyx)xxxyyyyx
xyxyxx(yx)xxyyyyx = xyxyxx(xy)xxyyyyx
xyxyxxyxy(yx)xyyx = xyxyxxyxy(xy)xyyx
xyxyxxyxy(yx)yxxy = xyxyxxyxy(xy)yxxy
xyxyxxy(yx)xxyyyx = xyxyxxy(xy)xxyyyx
xyxyxxy(yx)xyxyyx = xyxyxxy(xy)xyxyyx
xyxyxxy(yxxy)xyyx = xyxyxxy(xyyx)xyyx
xyxyxxy(yx)xyyxxy = xyxyxxy(xy)xyyxxy
xyxyxxy(yxxy)yxxy = xyxyxxy(xyyx)yxxy
xyxyxxy(yx)xyyxyx = xyxyxxy(xy)xyyxyx
xyxyxxy(yx)xyyyxx = xyxyxxy(xy)xyyyxx
xyxyxxy(yx)yxxxyy = xyxyxxy(xy)yxxxyy
xyxyxxy(yx)yxxyxy = xyxyxxy(xy)yxxyxy
xyxyxxy(yxyx)xyyx = xyxyxxy(xyxy)xyyx
xyxyxxy(yx)yxxyyx = xyxyxxy(xy)yxxyyx
xyxyxxyyx(yx)xyyx = xyxyxxyyx(xy)xyyx
xyxyxxy(yxyx)yxxy = xyxyxxy(xyxy)yxxy
xyxyxxy(yx)yxyxxy = xyxyxxy(xy)yxyxxy
xyxyxxyyx(yx)yxxy = xyxyxxyyx(xy)yxxy
xyxyxxy(yx)yyxxxy = xyxyxxy(xy)yyxxxy
xyx(yx)yxxxxxyyyy = xyx(xy)yxxxxxyyyy
xyx(yx)yxxxxyxyyy = xyx(xy)yxxxxyxyyy
xyx(yx)yxxxxyyxyy = xyx(xy)yxxxxyyxyy
xyx(yx)yxxxxyyyxy = xyx(xy)yxxxxyyyxy
xyx(yxyxx)xxyyyyx = xyx(xyxxy)xxyyyyx
xyx(yxyx)xxxyyyyx = xyx(xyxy)xxxyyyyx
xyx(yx)yxxxxyyyyx = xyx(xy)yxxxxyyyyx
xyxyx(yxx)xxyyyyx = xyxyx(xxy)xxyyyyx
xyxyx(yx)xxxyyyyx = xyxyx(xy)xxxyyyyx
xyxyx(yx)xxyxyyyx = xyxyx(xy)xxyxyyyx
xyxyx(yx)xxyyxyyx = xyxyx(xy)xxyyxyyx
xyxyx(yx)xxyyyxxy = xyxyx(xy)xxyyyxxy
xyxyx(yx)xxyyyxyx = xyxyx(xy)xxyyyxyx
xyxyx(yx)xxyyyyxx = xyxyx(xy)xxyyyyxx
xyxyx(yx)xyxxyyyx = xyxyx(xy)xyxxyyyx
xyxyx(yxxy)xxyyyx = xyxyx(xyyx)xxyyyx
xyxyxyxxy(yx)xyyx = xyxyxyxxy(xy)xyyx
xyxyxyxxy(yx)yxxy = xyxyxyxxy(xy)yxxy
xyxyx(yx)yxxxxyyy = xyxyx(xy)yxxxxyyy
xyxyx(yx)yxxxyxyy = xyxyx(xy)yxxxyxyy
xyxyx(yx)yxxxyyxy = xyxyx(xy)yxxxyyxy
xyxyx(yxyx)xxyyyx = xyxyx(xyxy)xxyyyx
xyxyx(yx)yxxxyyyx = xyxyx(xy)yxxxyyyx
xyxyxyx(yx)xxyyyx = xyxyxyx(xy)xxyyyx
xyxyxyx(yx)yxxxyy = xyxyxyx(xy)yxxxyy
xyxyxy(yx)xyyyxxx = xyxyxy(xy)xyyyxxx
xyxyxyyx(yx)xyyxx = xyxyxyyx(xy)xyyxx
xyxyxyyx(yx)yxxxy = xyxyxyyx(xy)yxxxy
xyxyxyyx(yx)yxxyx = xyxyxyyx(xy)yxxyx
xyxyxy(yx)yyxxxxy = xyxyxy(xy)yyxxxxy
xyxyxy(yx)yyxxxyx = xyxyxy(xy)yyxxxyx
xyxyxyyyxx(yx)xyx = xyxyxyyyxx(xy)xyx
xyxyyxxxy(yx)xyyx = xyxyyxxxy(xy)xyyx
xyxyyxxxy(yx)yxxy = xyxyyxxxy(xy)yxxy
xyxyyxx(yx)xxyyxy = xyxyyxx(xy)xxyyxy
xyxyyxx(yx)xxyyyx = xyxyyxx(xy)xxyyyx
xyxyyxx(yx)xyxxyy = xyxyyxx(xy)xyxxyy
xyxyyxx(yx)yxxxyy = xyxyyxx(xy)yxxxyy
xyxyyxxy(yx)xyyxx = xyxyyxxy(xy)xyyxx
xyxyyxxy(yx)yxxxy = xyxyyxxy(xy)yxxxy
xyxyyxxy(yx)yxxyx = xyxyyxxy(xy)yxxyx
xyxy(yx)xyyyyxxxx = xyxy(xy)xyyyyxxxx
xyxyyx(yx)xxyyyxx = xyxyyx(xy)xxyyyxx
xyxyyx(yx)xyxyyxx = xyxyyx(xy)xyxyyxx
xyxyyx(yxxy)xyyxx = xyxyyx(xyyx)xyyxx
xyxyyx(yx)xyyxxxy = xyxyyx(xy)xyyxxxy
xyxyyx(yxxy)yxxxy = xyxyyx(xyyx)yxxxy
xyxyyx(yx)xyyxxyx = xyxyyx(xy)xyyxxyx
xyxyyx(yxxy)yxxyx = xyxyyx(xyyx)yxxyx
xyxyyx(yx)xyyxyxx = xyxyyx(xy)xyyxyxx
xyxyyx(yx)xyyyxxx = xyxyyx(xy)xyyyxxx
xyxyyx(yx)yxxxxyy = xyxyyx(xy)yxxxxyy
xyxyyx(yx)yxxxyxy = xyxyyx(xy)yxxxyxy
xyxyyx(yx)yxxxyyx = xyxyyx(xy)yxxxyyx
xyxyyx(yx)yxxyxxy = xyxyyx(xy)yxxyxxy
xyxyyx(yx)yxxyxyx = xyxyyx(xy)yxxyxyx
xyxyyx(yxyx)xyyxx = xyxyyx(xyxy)xyyxx
xyxyyx(yx)yxxyyxx = xyxyyx(xy)yxxyyxx
xyxyyxyx(yx)xyyxx = xyxyyxyx(xy)xyyxx
xyxyyx(yxyx)yxxxy = xyxyyx(xyxy)yxxxy
xyxyyx(yx)yxyxxxy = xyxyyx(xy)yxyxxxy
xyxyyxyx(yx)yxxxy = xyxyyxyx(xy)yxxxy
xyxyyx(yxyx)yxxyx = xyxyyx(xyxy)yxxyx
xyxyyx(yx)yxyxxyx = xyxyyx(xy)yxyxxyx
xyxyyxyx(yx)yxxyx = xyxyyxyx(xy)yxxyx
xyxyyx(yx)yyxxxxy = xyxyyx(xy)yyxxxxy
xyxyyx(yx)yyxxxyx = xyxyyx(xy)yyxxxyx
xyxy(yx)yyxxxxxyy = xyxy(xy)yyxxxxxyy
xyxy(yx)yyxxxxyxy = xyxy(xy)yyxxxxyxy
xyxy(yx)yyxxxxyyx = xyxy(xy)yyxxxxyyx
xyxy(yx)yyxxxyxxy = xyxy(xy)yyxxxyxxy
xyxy(yx)yyxxxyxyx = xyxy(xy)yyxxxyxyx
xyxy(yxyyxxxy)xyx = xyxy(xyyyxxyx)xyx
xyxy(yx)yyxxxyyxx = xyxy(xy)yyxxxyyxx
xyxy(yx)yyxxyxxxy = xyxy(xy)yyxxyxxxy
xyxy(yxyyxxyx)xyx = xyxy(xyyyxxxy)xyx
xyxy(yx)yyxxyxxyx = xyxy(xy)yyxxyxxyx
xyxyyxyyxx(yx)xyx = xyxyyxyyxx(xy)xyx
xyxy(yx)yyxyxxxxy = xyxy(xy)yyxyxxxxy
xyxy(yx)yyxyxxxyx = xyxy(xy)yyxyxxxyx
xyxy(yx)yyyxxxxxy = xyxy(xy)yyyxxxxxy
xyxy(yx)yyyxxxxyx = xyxy(xy)yyyxxxxyx
xyxyyyxx(yx)xxyyx = xyxyyyxx(xy)xxyyx
xyxyyyxx(yx)xyxxy = xyxyyyxx(xy)xyxxy
xyxyyyxx(yx)xyxyx = xyxyyyxx(xy)xyxyx
xyxyyyxx(yx)xyyxx = xyxyyyxx(xy)xyyxx
xyxyyyxx(yx)yxxxy = xyxyyyxx(xy)yxxxy
xyxyyyxx(yx)yxxyx = xyxyyyxx(xy)yxxyx
xyxyyyxyxx(yx)xyx = xyxyyyxyxx(xy)xyx
xyxyyyx(yx)xyyxxx = xyxyyyx(xy)xyyxxx
xyxyyyx(yx)yxxxxy = xyxyyyx(xy)yxxxxy
xyxyyyx(yx)yxxxyx = xyxyyyx(xy)yxxxyx
xyxyyyx(yx)yxxyxx = xyxyyyx(xy)yxxyxx
xyxyyyyxxx(yx)xyx = xyxyyyyxxx(xy)xyx
xyxyyyyxx(yx)xyxx = xyxyyyyxx(xy)xyxx
xyyxxxxxyy(yx)yxy = xyyxxxxxyy(xy)yxy
xyyxxxxy(yx)xyxyy = xyyxxxxy(xy)xyxyy
xyyxxxxy(yx)xyyxy = xyyxxxxy(xy)xyyxy
xyyxxxxy(yx)xyyyx = xyyxxxxy(xy)xyyyx
xyyxxxxy(yx)yxxyy = xyyxxxxy(xy)yxxyy
xyyxxxxyy(yx)xyyx = xyyxxxxyy(xy)xyyx
xyyxxxxyy(yx)yxxy = xyyxxxxyy(xy)yxxy
xyyxxxxyy(yx)yxyx = xyyxxxxyy(xy)yxyx
xyyxxx(yx)xxyxyyy = xyyxxx(xy)xxyxyyy
xyyxxx(yx)xxyyxyy = xyyxxx(xy)xxyyxyy
xyyxxx(yx)xxyyyxy = xyyxxx(xy)xxyyyxy
xyyxxx(yx)xxyyyyx = xyyxxx(xy)xxyyyyx
xyyxxxyxy(yx)xyyx = xyyxxxyxy(xy)xyyx
xyyxxxyxy(yx)yxxy = xyyxxxyxy(xy)yxxy
xyyxxxy(yx)xxyyxy = xyyxxxy(xy)xxyyxy
xyyxxxy(yx)xxyyyx = xyyxxxy(xy)xxyyyx
xyyxxxy(yx)xyxyxy = xyyxxxy(xy)xyxyxy
xyyxxxy(yx)xyxyyx = xyyxxxy(xy)xyxyyx
xyyxxxy(yxxy)xyyx = xyyxxxy(xyyx)xyyx
xyyxxxy(yx)xyyxxy = xyyxxxy(xy)xyyxxy
xyyxxxy(yxxy)yxxy = xyyxxxy(xyyx)yxxy
xyyxxxy(yx)xyyxyx = xyyxxxy(xy)xyyxyx
xyyxxxy(yx)xyyyxx = xyyxxxy(xy)xyyyxx
xyyxxxy(yx)yxxxyy = xyyxxxy(xy)yxxxyy
xyyxxxy(yx)yxxyxy = xyyxxxy(xy)yxxyxy
xyyxxxy(yxyx)xyyx = xyyxxxy(xyxy)xyyx
xyyxxxy(yx)yxxyyx = xyyxxxy(xy)yxxyyx
xyyxxxyyx(yx)xyyx = xyyxxxyyx(xy)xyyx
xyyxxxy(yxyx)yxxy = xyyxxxy(xyxy)yxxy
xyyxxxy(yx)yxyxxy = xyyxxxy(xy)yxyxxy
xyyxxxyyx(yx)yxxy = xyyxxxyyx(xy)yxxy
xyyxxxy(yx)yyxxxy = xyyxxxy(xy)yyxxxy
xyyxxxyy(yx)xyyxx = xyyxxxyy(xy)xyyxx
xyyxxxy(yyx)yxxxy = xyyxxxy(xyy)yxxxy
xyyxxxyy(yx)yxxxy = xyyxxxyy(xy)yxxxy
xyyxxxyy(yx)yxxyx = xyyxxxyy(xy)yxxyx
xyyxxxyy(yx)yxyxx = xyyxxxyy(xy)yxyxx
xyyxx(yxx)xxyyxyy = xyyxx(xxy)xxyyxyy
xyyxx(yx)xxxyyxyy = xyyxx(xy)xxxyyxyy
xyyxx(yxx)xxyyyxy = xyyxx(xxy)xxyyyxy
xyyxx(yx)xxxyyyxy = xyyxx(xy)xxxyyyxy
xyyxx(yxx)xxyyyyx = xyyxx(xxy)xxyyyyx
xyyxx(yx)xxxyyyyx = xyyxx(xy)xxxyyyyx
xyyxx(yx)xxyxyxyy = xyyxx(xy)xxyxyxyy
xyyxx(yx)xxyxyyxy = xyyxx(xy)xxyxyyxy
xyyxx(yx)xxyxyyyx = xyyxx(xy)xxyxyyyx
xyyxx(yx)xxyyxxyy = xyyxx(xy)xxyyxxyy
xyyxx(yx)xxyyxyxy = xyyxx(xy)xxyyxyxy
xyyxx(yx)xxyyxyyx = xyyxx(xy)xxyyxyyx
xyyxx(yx)xxyyyxxy = xyyxx(xy)xxyyyxxy
xyyxx(yx)xxyyyxyx = xyyxx(xy)xxyyyxyx
xyyxx(yx)xxyyyyxx = xyyxx(xy)xxyyyyxx
xyyxx(yx)xyxxxyyy = xyyxx(xy)xyxxxyyy
xyyxx(yx)xyxxyxyy = xyyxx(xy)xyxxyxyy
xyyxx(yx)xyxxyyxy = xyyxx(xy)xyxxyyxy
xyyxx(yxxy)xxyyxy = xyyxx(xyyx)xxyyxy
xyyxx(yx)xyxxyyyx = xyyxx(xy)xyxxyyyx
xyyxx(yxxy)xxyyyx = xyyxx(xyyx)xxyyyx
xyyxxyxxy(yx)xyyx = xyyxxyxxy(xy)xyyx
xyyxxyxxy(yx)yxxy = xyyxxyxxy(xy)yxxy
xyyxx(yx)yxxxxyyy = xyyxx(xy)yxxxxyyy
xyyxx(yx)yxxxyxyy = xyyxx(xy)yxxxyxyy
xyyxx(yxyx)xxyyxy = xyyxx(xyxy)xxyyxy
xyyxx(yx)yxxxyyxy = xyyxx(xy)yxxxyyxy
xyyxxyx(yx)xxyyxy = xyyxxyx(xy)xxyyxy
xyyxx(yxyx)xxyyyx = xyyxx(xyxy)xxyyyx
xyyxx(yx)yxxxyyyx = xyyxx(xy)yxxxyyyx
xyyxxyx(yx)xxyyyx = xyyxxyx(xy)xxyyyx
xyyxxyx(yx)yxxxyy = xyyxxyx(xy)yxxxyy
xyyxxyxy(yx)xyyxx = xyyxxyxy(xy)xyyxx
xyyxxyxy(yx)yxxxy = xyyxxyxy(xy)yxxxy
xyyxxyxy(yx)yxxyx = xyyxxyxy(xy)yxxyx
xyyxxy(yx)xxyyyxx = xyyxxy(xy)xxyyyxx
xyyxxy(yx)xyxyyxx = xyyxxy(xy)xyxyyxx
xyyxxy(yxxy)xyyxx = xyyxxy(xyyx)xyyxx
xyyxxy(yx)xyyxxxy = xyyxxy(xy)xyyxxxy
xyyxxy(yxxy)yxxxy = xyyxxy(xyyx)yxxxy
xyyxxy(yx)xyyxxyx = xyyxxy(xy)xyyxxyx
xyyxxy(yxxy)yxxyx = xyyxxy(xyyx)yxxyx
xyyxxy(yx)xyyxyxx = xyyxxy(xy)xyyxyxx
xyyxxy(yx)xyyyxxx = xyyxxy(xy)xyyyxxx
xyyxxy(yx)yxxxxyy = xyyxxy(xy)yxxxxyy
xyyxxy(yx)yxxxyxy = xyyxxy(xy)yxxxyxy
xyyxxy(yx)yxxxyyx = xyyxxy(xy)yxxxyyx
xyyxxy(yx)yxxyxxy = xyyxxy(xy)yxxyxxy
xyyxxy(yx)yxxyxyx = xyyxxy(xy)yxxyxyx
xyyxxy(yxyx)xyyxx = xyyxxy(xyxy)xyyxx
xyyxxy(yx)yxxyyxx = xyyxxy(xy)yxxyyxx
xyyxxyyx(yx)xyyxx = xyyxxyyx(xy)xyyxx
xyyxxy(yxyx)yxxxy = xyyxxy(xyxy)yxxxy
xyyxxy(yx)yxyxxxy = xyyxxy(xy)yxyxxxy
xyyxxyyx(yx)yxxxy = xyyxxyyx(xy)yxxxy
xyyxxy(yxyx)yxxyx = xyyxxy(xyxy)yxxyx
xyyxxy(yx)yxyxxyx = xyyxxy(xy)yxyxxyx
xyyxxyyx(yx)yxxyx = xyyxxyyx(xy)yxxyx
xyyxxy(yx)yyxxxxy = xyyxxy(xy)yyxxxxy
xyyxxy(yx)yyxxxyx = xyyxxy(xy)yyxxxyx
xyyxxyyyxx(yx)xyx = xyyxxyyyxx(xy)xyx
xyyx(yxx)xxyyyyxx = xyyx(xxy)xxyyyyxx
xyyx(yx)xxxyyyyxx = xyyx(xy)xxxyyyyxx
xyyx(yx)xxyxyyyxx = xyyx(xy)xxyxyyyxx
xyyxyxxxy(yx)xyyx = xyyxyxxxy(xy)xyyx
xyyxyxxxy(yx)yxxy = xyyxyxxxy(xy)yxxy
xyyx(yx)xxyyxyyxx = xyyx(xy)xxyyxyyxx
xyyx(yx)xxyyyxxxy = xyyx(xy)xxyyyxxxy
xyyx(yx)xxyyyxxyx = xyyx(xy)xxyyyxxyx
xyyx(yx)xxyyyxyxx = xyyx(xy)xxyyyxyxx
xyyx(yx)xxyyyyxxx = xyyx(xy)xxyyyyxxx
xyyxyxx(yx)xxyyxy = xyyxyxx(xy)xxyyxy
xyyxyxx(yx)xxyyyx = xyyxyxx(xy)xxyyyx
xyyxyxx(yx)xyxxyy = xyyxyxx(xy)xyxxyy
xyyx(yx)xyxxyyyxx = xyyx(xy)xyxxyyyxx
xyyx(yxxy)xxyyyxx = xyyx(xyyx)xxyyyxx
xyyxyxx(yx)yxxxyy = xyyxyxx(xy)yxxxyy
xyyx(yx)xyxyxyyxx = xyyx(xy)xyxyxyyxx
xyyx(yxxyxy)xyyxx = xyyx(xyxyyx)xyyxx
xyyx(yxxy)xyxyyxx = xyyx(xyyx)xyxyyxx
xyyx(yxxyxy)xyyxx = xyyx(xyyxyx)xyyxx
xyyx(yx)xyxyyxxxy = xyyx(xy)xyxyyxxxy
xyyx(yxxyxy)yxxxy = xyyx(xyxyyx)yxxxy
xyyx(yxxy)xyyxxxy = xyyx(xyyx)xyyxxxy
xyyx(yxxyxy)yxxxy = xyyx(xyyxyx)yxxxy
xyyx(yx)xyxyyxxyx = xyyx(xy)xyxyyxxyx
xyyx(yxxyxy)yxxyx = xyyx(xyxyyx)yxxyx
xyyx(yxxy)xyyxxyx = xyyx(xyyx)xyyxxyx
xyyx(yxxyxy)yxxyx = xyyx(xyyxyx)yxxyx
xyyx(yx)xyxyyxyxx = xyyx(xy)xyxyyxyxx
xyyx(yxxy)xyyxyxx = xyyx(xyyx)xyyxyxx
xyyx(yx)xyxyyyxxx = xyyx(xy)xyxyyyxxx
xyyx(yxxy)xyyyxxx = xyyx(xyyx)xyyyxxx
xyyx(yx)xyyxxxxyy = xyyx(xy)xyyxxxxyy
xyyx(yxxy)yxxxxyy = xyyx(xyyx)yxxxxyy
xyyx(yx)xyyxxxyxy = xyyx(xy)xyyxxxyxy
xyyx(yxxy)yxxxyxy = xyyx(xyyx)yxxxyxy
xyyx(yx)xyyxxxyyx = xyyx(xy)xyyxxxyyx
xyyx(yxxy)yxxxyyx = xyyx(xyyx)yxxxyyx
xyyx(yx)xyyxxyxxy = xyyx(xy)xyyxxyxxy
xyyx(yxxy)yxxyxxy = xyyx(xyyx)yxxyxxy
xyyx(yx)xyyxxyxyx = xyyx(xy)xyyxxyxyx
xyyx(yxxy)yxxyxyx = xyyx(xyyx)yxxyxyx
xyyx(yxxyyx)xyyxx = xyyx(xyxyxy)xyyxx
xyyx(yx)xyyxxyyxx = xyyx(xy)xyyxxyyxx
xyyx(yxxyyx)xyyxx = xyyx(xyyxxy)xyyxx
xyyx(yxxy)yxxyyxx = xyyx(xyyx)yxxyyxx
xyyxyxxy(yx)xyyxx = xyyxyxxy(xy)xyyxx
xyyx(yxxyyx)yxxxy = xyyx(xyxyxy)yxxxy
xyyx(yx)xyyxyxxxy = xyyx(xy)xyyxyxxxy
xyyx(yxxyyx)yxxxy = xyyx(xyyxxy)yxxxy
xyyx(yxxy)yxyxxxy = xyyx(xyyx)yxyxxxy
xyyxyxxy(yx)yxxxy = xyyxyxxy(xy)yxxxy
xyyx(yxxyyx)yxxyx = xyyx(xyxyxy)yxxyx
xyyx(yx)xyyxyxxyx = xyyx(xy)xyyxyxxyx
xyyx(yxxyyx)yxxyx = xyyx(xyyxxy)yxxyx
xyyx(yxxy)yxyxxyx = xyyx(xyyx)yxyxxyx
xyyxyxxy(yx)yxxyx = xyyxyxxy(xy)yxxyx
xyyx(yx)xyyxyxyxx = xyyx(xy)xyyxyxyxx
xyyx(yx)xyyxyyxxx = xyyx(xy)xyyxyyxxx
xyyx(yx)xyyyxxxxy = xyyx(xy)xyyyxxxxy
xyyx(yxxy)yyxxxxy = xyyx(xyyx)yyxxxxy
xyyx(yx)xyyyxxxyx = xyyx(xy)xyyyxxxyx
xyyx(yxxy)yyxxxyx = xyyx(xyyx)yyxxxyx
xyyx(yx)xyyyxxyxx = xyyx(xy)xyyyxxyxx
xyyx(yx)xyyyxyxxx = xyyx(xy)xyyyxyxxx
xyyx(yx)xyyyyxxxx = xyyx(xy)xyyyyxxxx
xyyx(yx)yxxxxxyyy = xyyx(xy)yxxxxxyyy
xyyx(yx)yxxxxyxyy = xyyx(xy)yxxxxyxyy
xyyx(yx)yxxxxyyxy = xyyx(xy)yxxxxyyxy
xyyx(yx)yxxxxyyyx = xyyx(xy)yxxxxyyyx
xyyx(yx)yxxxyxxyy = xyyx(xy)yxxxyxxyy
xyyx(yx)yxxxyxyxy = xyyx(xy)yxxxyxyxy
xyyx(yx)yxxxyxyyx = xyyx(xy)yxxxyxyyx
xyyx(yx)yxxxyyxxy = xyyx(xy)yxxxyyxxy
xyyx(yx)yxxxyyxyx = xyyx(xy)yxxxyyxyx
xyyx(yxyx)xxyyyxx = xyyx(xyxy)xxyyyxx
xyyx(yx)yxxxyyyxx = xyyx(xy)yxxxyyyxx
xyyxyx(yx)xxyyyxx = xyyxyx(xy)xxyyyxx
xyyx(yx)yxxyxxxyy = xyyx(xy)yxxyxxxyy
xyyx(yx)yxxyxxyxy = xyyx(xy)yxxyxxyxy
xyyx(yx)yxxyxxyyx = xyyx(xy)yxxyxxyyx
xyyx(yx)yxxyxyxxy = xyyx(xy)yxxyxyxxy
xyyx(yx)yxxyxyxyx = xyyx(xy)yxxyxyxyx
xyyx(yxyx)xyxyyxx = xyyx(xyxy)xyxyyxx
xyyx(yxyxxy)xyyxx = xyyx(xyxyyx)xyyxx
xyyx(yx)yxxyxyyxx = xyyx(xy)yxxyxyyxx
xyyx(yxyxxy)xyyxx = xyyx(xyyxyx)xyyxx
xyyxyx(yx)xyxyyxx = xyyxyx(xy)xyxyyxx
xyyxyx(yxxy)xyyxx = xyyxyx(xyyx)xyyxx
xyyx(yxyx)xyyxxxy = xyyx(xyxy)xyyxxxy
xyyx(yxyxxy)yxxxy = xyyx(xyxyyx)yxxxy
xyyx(yx)yxxyyxxxy = xyyx(xy)yxxyyxxxy
xyyx(yxyxxy)yxxxy = xyyx(xyyxyx)yxxxy
xyyxyx(yx)xyyxxxy = xyyxyx(xy)xyyxxxy
xyyxyx(yxxy)yxxxy = xyyxyx(xyyx)yxxxy
xyyx(yxyx)xyyxxyx = xyyx(xyxy)xyyxxyx
xyyx(yxyxxy)yxxyx = xyyx(xyxyyx)yxxyx
xyyx(yx)yxxyyxxyx = xyyx(xy)yxxyyxxyx
xyyx(yxyxxy)yxxyx = xyyx(xyyxyx)yxxyx
xyyxyx(yx)xyyxxyx = xyyxyx(xy)xyyxxyx
xyyxyx(yxxy)yxxyx = xyyxyx(xyyx)yxxyx
xyyx(yxyx)xyyxyxx = xyyx(xyxy)xyyxyxx
xyyx(yx)yxxyyxyxx = xyyx(xy)yxxyyxyxx
xyyxyx(yx)xyyxyxx = xyyxyx(xy)xyyxyxx
xyyx(yxyx)xyyyxxx = xyyx(xyxy)xyyyxxx
xyyx(yx)yxxyyyxxx = xyyx(xy)yxxyyyxxx
xyyxyx(yx)xyyyxxx = xyyxyx(xy)xyyyxxx
xyyx(yxyx)yxxxxyy = xyyx(xyxy)yxxxxyy
xyyx(yx)yxyxxxxyy = xyyx(xy)yxyxxxxyy
xyyxyx(yx)yxxxxyy = xyyxyx(xy)yxxxxyy
xyyx(yxyx)yxxxyxy = xyyx(xyxy)yxxxyxy
xyyx(yx)yxyxxxyxy = xyyx(xy)yxyxxxyxy
xyyxyx(yx)yxxxyxy = xyyxyx(xy)yxxxyxy
xyyx(yxyx)yxxxyyx = xyyx(xyxy)yxxxyyx
xyyx(yx)yxyxxxyyx = xyyx(xy)yxyxxxyyx
xyyxyx(yx)yxxxyyx = xyyxyx(xy)yxxxyyx
xyyx(yxyx)yxxyxxy = xyyx(xyxy)yxxyxxy
xyyx(yx)yxyxxyxxy = xyyx(xy)yxyxxyxxy
xyyxyx(yx)yxxyxxy = xyyxyx(xy)yxxyxxy
xyyx(yxyx)yxxyxyx = xyyx(xyxy)yxxyxyx
xyyx(yx)yxyxxyxyx = xyyx(xy)yxyxxyxyx
xyyxyx(yx)yxxyxyx = xyyxyx(xy)yxxyxyx
xyyx(yxyxyx)xyyxx = xyyx(xyxyxy)xyyxx
xyyx(yxyx)yxxyyxx = xyyx(xyxy)yxxyyxx
xyyx(yxyxyx)xyyxx = xyyx(xyyxxy)xyyxx
xyyx(yx)yxyxxyyxx = xyyx(xy)yxyxxyyxx
xyyxyx(yxyx)xyyxx = xyyxyx(xyxy)xyyxx
xyyxyx(yx)yxxyyxx = xyyxyx(xy)yxxyyxx
xyyxyxyx(yx)xyyxx = xyyxyxyx(xy)xyyxx
xyyx(yxyxyx)yxxxy = xyyx(xyxyxy)yxxxy
xyyx(yxyx)yxyxxxy = xyyx(xyxy)yxyxxxy
xyyx(yxyxyx)yxxxy = xyyx(xyyxxy)yxxxy
xyyx(yx)yxyxyxxxy = xyyx(xy)yxyxyxxxy
xyyxyx(yxyx)yxxxy = xyyxyx(xyxy)yxxxy
xyyxyx(yx)yxyxxxy = xyyxyx(xy)yxyxxxy
xyyxyxyx(yx)yxxxy = xyyxyxyx(xy)yxxxy
xyyx(yxyxyx)yxxyx = xyyx(xyxyxy)yxxyx
xyyx(yxyx)yxyxxyx = xyyx(xyxy)yxyxxyx
xyyx(yxyxyx)yxxyx = xyyx(xyyxxy)yxxyx
xyyx(yx)yxyxyxxyx = xyyx(xy)yxyxyxxyx
xyyxyx(yxyx)yxxyx = xyyxyx(xyxy)yxxyx
xyyxyx(yx)yxyxxyx = xyyxyx(xy)yxyxxyx
xyyxyxyx(yx)yxxyx = xyyxyxyx(xy)yxxyx
xyyx(yxyx)yyxxxxy = xyyx(xyxy)yyxxxxy
xyyx(yx)yxyyxxxxy = xyyx(xy)yxyyxxxxy
xyyxyx(yx)yyxxxxy = xyyxyx(xy)yyxxxxy
xyyx(yxyx)yyxxxyx = xyyx(xyxy)yyxxxyx
xyyx(yx)yxyyxxxyx = xyyx(xy)yxyyxxxyx
xyyxyx(yx)yyxxxyx = xyyxyx(xy)yyxxxyx
xyyx(yx)yyxxxxxyy = xyyx(xy)yyxxxxxyy
xyyx(yx)yyxxxxyxy = xyyx(xy)yyxxxxyxy
xyyx(yx)yyxxxxyyx = xyyx(xy)yyxxxxyyx
xyyx(yx)yyxxxyxxy = xyyx(xy)yyxxxyxxy
xyyx(yx)yyxxxyxyx = xyyx(xy)yyxxxyxyx
xyyx(yxyyxxxy)xyx = xyyx(xyyyxxyx)xyx
xyyx(yx)yyxxxyyxx = xyyx(xy)yyxxxyyxx
xyyx(yx)yyxxyxxxy = xyyx(xy)yyxxyxxxy
xyyx(yxyyxxyx)xyx = xyyx(xyyyxxxy)xyx
xyyx(yx)yyxxyxxyx = xyyx(xy)yyxxyxxyx
xyyxyxyyxx(yx)xyx = xyyxyxyyxx(xy)xyx
xyyx(yx)yyxyxxxxy = xyyx(xy)yyxyxxxxy
xyyx(yx)yyxyxxxyx = xyyx(xy)yyxyxxxyx
xyyx(yx)yyyxxxxxy = xyyx(xy)yyyxxxxxy
xyyx(yx)yyyxxxxyx = xyyx(xy)yyyxxxxyx
xyyxyyxx(yx)xxyyx = xyyxyyxx(xy)xxyyx
xyyxyyxx(yx)xyxxy = xyyxyyxx(xy)xyxxy
xyyxyyxx(yx)xyxyx = xyyxyyxx(xy)xyxyx
xyyxyyxx(yx)xyyxx = xyyxyyxx(xy)xyyxx
xyyxyyxx(yx)yxxxy = xyyxyyxx(xy)yxxxy
xyyxyyxx(yx)yxxyx = xyyxyyxx(xy)yxxyx
xyyxyyxyxx(yx)xyx = xyyxyyxyxx(xy)xyx
xyyxyyx(yx)xyyxxx = xyyxyyx(xy)xyyxxx
xyyxyyx(yx)yxxxxy = xyyxyyx(xy)yxxxxy
xyyxyyx(yx)yxxxyx = xyyxyyx(xy)yxxxyx
xyyxyyx(yx)yxxyxx = xyyxyyx(xy)yxxyxx
xyyx(yyx)yyxxxxxy = xyyx(xyy)yyxxxxxy
xyyxy(yx)yyxxxxxy = xyyxy(xy)yyxxxxxy
xyyx(yyx)yyxxxxyx = xyyx(xyy)yyxxxxyx
xyyxy(yx)yyxxxxyx = xyyxy(xy)yyxxxxyx
xyyxy(yx)yyxxxyxx = xyyxy(xy)yyxxxyxx
xyyxy(yx)yyxxyxxx = xyyxy(xy)yyxxyxxx
xyyxyyyxxx(yx)xyx = xyyxyyyxxx(xy)xyx
xyyxyyyxx(yx)xyxx = xyyxyyyxx(xy)xyxx
xyyyxxxxy(yx)xyxy = xyyyxxxxy(xy)xyxy
xyyyxxxxy(yx)xyyx = xyyyxxxxy(xy)xyyx
xyyyxxxxy(yx)yxxy = xyyyxxxxy(xy)yxxy
xyyyxxx(yx)xxyxyy = xyyyxxx(xy)xxyxyy
xyyyxxx(yx)xxyyxy = xyyyxxx(xy)xxyyxy
xyyyxxx(yx)xxyyyx = xyyyxxx(xy)xxyyyx
xyyyxxx(yx)xyxxyy = xyyyxxx(xy)xyxxyy
xyyyxxx(yx)yxxxyy = xyyyxxx(xy)yxxxyy
xyyyxxxy(yx)xxyyx = xyyyxxxy(xy)xxyyx
xyyyxxxy(yx)xyxyx = xyyyxxxy(xy)xyxyx
xyyyxxxy(yx)xyyxx = xyyyxxxy(xy)xyyxx
xyyyxxxy(yx)yxxxy = xyyyxxxy(xy)yxxxy
xyyyxxxy(yx)yxxyx = xyyyxxxy(xy)yxxyx
xyyyxx(yxx)xxyyxy = xyyyxx(xxy)xxyyxy
xyyyxx(yx)xxxyyxy = xyyyxx(xy)xxxyyxy
xyyyxx(yxx)xxyyyx = xyyyxx(xxy)xxyyyx
xyyyxx(yx)xxxyyyx = xyyyxx(xy)xxxyyyx
xyyyxx(yx)xxyxyxy = xyyyxx(xy)xxyxyxy
xyyyxx(yx)xxyxyyx = xyyyxx(xy)xxyxyyx
xyyyxx(yx)xxyyxxy = xyyyxx(xy)xxyyxxy
xyyyxx(yx)xxyyxyx = xyyyxx(xy)xxyyxyx
xyyyxx(yx)xxyyyxx = xyyyxx(xy)xxyyyxx
xyyyxx(yxx)yxxxyy = xyyyxx(xxy)yxxxyy
xyyyxx(yx)xyxxxyy = xyyyxx(xy)xyxxxyy
xyyyxx(yx)xyxxyxy = xyyyxx(xy)xyxxyxy
xyyyxx(yx)xyxxyyx = xyyyxx(xy)xyxxyyx
xyyyxx(yxxy)xxyyx = xyyyxx(xyyx)xxyyx
xyyyxx(yx)xyxyxxy = xyyyxx(xy)xyxyxxy
xyyyxx(yx)xyxyxyx = xyyyxx(xy)xyxyxyx
xyyyxx(yxxy)xyxyx = xyyyxx(xyyx)xyxyx
xyyyxx(yx)xyxyyxx = xyyyxx(xy)xyxyyxx
xyyyxx(yxxy)xyyxx = xyyyxx(xyyx)xyyxx
xyyyxx(yx)xyyxxxy = xyyyxx(xy)xyyxxxy
xyyyxx(yxxy)yxxxy = xyyyxx(xyyx)yxxxy
xyyyxx(yx)xyyxxyx = xyyyxx(xy)xyyxxyx
xyyyxx(yxxy)yxxyx = xyyyxx(xyyx)yxxyx
xyyyxx(yx)xyyxyxx = xyyyxx(xy)xyyxyxx
xyyyxx(yx)xyyyxxx = xyyyxx(xy)xyyyxxx
xyyyxx(yx)yxxxxyy = xyyyxx(xy)yxxxxyy
xyyyxx(yx)yxxxyxy = xyyyxx(xy)yxxxyxy
xyyyxx(yxyx)xxyyx = xyyyxx(xyxy)xxyyx
xyyyxx(yx)yxxxyyx = xyyyxx(xy)yxxxyyx
xyyyxxyx(yx)xxyyx = xyyyxxyx(xy)xxyyx
xyyyxx(yx)yxxyxxy = xyyyxx(xy)yxxyxxy
xyyyxx(yxyx)xyxyx = xyyyxx(xyxy)xyxyx
xyyyxx(yx)yxxyxyx = xyyyxx(xy)yxxyxyx
xyyyxxyx(yx)xyxyx = xyyyxxyx(xy)xyxyx
xyyyxx(yxyx)xyyxx = xyyyxx(xyxy)xyyxx
xyyyxx(yx)yxxyyxx = xyyyxx(xy)yxxyyxx
xyyyxxyx(yx)xyyxx = xyyyxxyx(xy)xyyxx
xyyyxx(yxyx)yxxxy = xyyyxx(xyxy)yxxxy
xyyyxx(yx)yxyxxxy = xyyyxx(xy)yxyxxxy
xyyyxxyx(yx)yxxxy = xyyyxxyx(xy)yxxxy
xyyyxx(yxyx)yxxyx = xyyyxx(xyxy)yxxyx
xyyyxx(yx)yxyxxyx = xyyyxx(xy)yxyxxyx
xyyyxxyx(yx)yxxyx = xyyyxxyx(xy)yxxyx
xyyyxx(yx)yyxxxxy = xyyyxx(xy)yyxxxxy
xyyyxx(yx)yyxxxyx = xyyyxx(xy)yyxxxyx
xyyyxxyyxx(yx)xyx = xyyyxxyyxx(xy)xyx
xyyyxxy(yx)xyyxxx = xyyyxxy(xy)xyyxxx
xyyyxx(yyx)yxxxxy = xyyyxx(xyy)yxxxxy
xyyyxxy(yx)yxxxxy = xyyyxxy(xy)yxxxxy
xyyyxx(yyx)yxxxyx = xyyyxx(xyy)yxxxyx
xyyyxxy(yx)yxxxyx = xyyyxxy(xy)yxxxyx
xyyyxxy(yx)yxxyxx = xyyyxxy(xy)yxxyxx
xyyyx(yxx)xyyyxxx = xyyyx(xxy)xyyyxxx
xyyyx(yx)xxyyyxxx = xyyyx(xy)xxyyyxxx
xyyyxyxx(yx)xxyyx = xyyyxyxx(xy)xxyyx
xyyyxyxx(yx)xyxxy = xyyyxyxx(xy)xyxxy
xyyyxyxx(yx)xyxyx = xyyyxyxx(xy)xyxyx
xyyyxyxx(yx)xyyxx = xyyyxyxx(xy)xyyxx
xyyyxyxx(yx)yxxxy = xyyyxyxx(xy)yxxxy
xyyyxyxx(yx)yxxyx = xyyyxyxx(xy)yxxyx
xyyyx(yx)xyxyyxxx = xyyyx(xy)xyxyyxxx
xyyyx(yxxy)xyyxxx = xyyyx(xyyx)xyyxxx
xyyyx(yxx)yyxxxxy = xyyyx(xxy)yyxxxxy
xyyyx(yx)xyyxxxxy = xyyyx(xy)xyyxxxxy
xyyyx(yxxy)yxxxxy = xyyyx(xyyx)yxxxxy
xyyyx(yxx)yyxxxyx = xyyyx(xxy)yyxxxyx
xyyyx(yx)xyyxxxyx = xyyyx(xy)xyyxxxyx
xyyyx(yxxy)yxxxyx = xyyyx(xyyx)yxxxyx
xyyyx(yx)xyyxxyxx = xyyyx(xy)xyyxxyxx
xyyyx(yxxy)yxxyxx = xyyyx(xyyx)yxxyxx
xyyyx(yx)xyyxyxxx = xyyyx(xy)xyyxyxxx
xyyyx(yx)xyyyxxxx = xyyyx(xy)xyyyxxxx
xyyyx(yx)yxxxxxyy = xyyyx(xy)yxxxxxyy
xyyyx(yx)yxxxxyxy = xyyyx(xy)yxxxxyxy
xyyyx(yx)yxxxxyyx = xyyyx(xy)yxxxxyyx
xyyyx(yx)yxxxyxxy = xyyyx(xy)yxxxyxxy
xyyyx(yx)yxxxyxyx = xyyyx(xy)yxxxyxyx
xyyyx(yxyxxxy)xyx = xyyyx(xyyxxyx)xyx
xyyyx(yx)yxxxyyxx = xyyyx(xy)yxxxyyxx
xyyyx(yx)yxxyxxxy = xyyyx(xy)yxxyxxxy
xyyyx(yxyxxyx)xyx = xyyyx(xyyxxxy)xyx
xyyyx(yx)yxxyxxyx = xyyyx(xy)yxxyxxyx
xyyyxyxyxx(yx)xyx = xyyyxyxyxx(xy)xyx
xyyyx(yx)yxxyxyxx = xyyyx(xy)yxxyxyxx
xyyyx(yxyx)xyyxxx = xyyyx(xyxy)xyyxxx
xyyyx(yx)yxxyyxxx = xyyyx(xy)yxxyyxxx
xyyyxyx(yx)xyyxxx = xyyyxyx(xy)xyyxxx
xyyyx(yxyx)yxxxxy = xyyyx(xxyy)yxxxxy
xyyyx(yxyx)yxxxxy = xyyyx(xyxy)yxxxxy
xyyyx(yx)yxyxxxxy = xyyyx(xy)yxyxxxxy
xyyyxyx(yx)yxxxxy = xyyyxyx(xy)yxxxxy
xyyyx(yxyx)yxxxyx = xyyyx(xxyy)yxxxyx
xyyyx(yxyx)yxxxyx = xyyyx(xyxy)yxxxyx
xyyyx(yx)yxyxxxyx = xyyyx(xy)yxyxxxyx
xyyyxyx(yx)yxxxyx = xyyyxyx(xy)yxxxyx
xyyyx(yxyx)yxxyxx = xyyyx(xyxy)yxxyxx
xyyyx(yx)yxyxxyxx = xyyyx(xy)yxyxxyxx
xyyyxyx(yx)yxxyxx = xyyyxyx(xy)yxxyxx
xyyyx(yx)yxyxyxxx = xyyyx(xy)yxyxyxxx
xyyyx(yx)yyxxxxxy = xyyyx(xy)yyxxxxxy
xyyyx(yx)yyxxxxyx = xyyyx(xy)yyxxxxyx
xyyyx(yx)yyxxxyxx = xyyyx(xy)yyxxxyxx
xyyyx(yx)yyxxyxxx = xyyyx(xy)yyxxyxxx
xyyyxyyxxx(yx)xyx = xyyyxyyxxx(xy)xyx
xyyyxyyxx(yx)xyxx = xyyyxyyxx(xy)xyxx
xyyyyxxxxy(yx)xyx = xyyyyxxxxy(xy)xyx
xyyyyxxx(yx)xxyxy = xyyyyxxx(xy)xxyxy
xyyyyxxx(yx)xxyyx = xyyyyxxx(xy)xxyyx
xyyyyxxx(yx)xyxxy = xyyyyxxx(xy)xyxxy
xyyyyxxx(yx)xyxyx = xyyyyxxx(xy)xyxyx
xyyyyxxx(yxxy)xyx = xyyyyxxx(xyyx)xyx
xyyyyxxx(yx)xyyxx = xyyyyxxx(xy)xyyxx
xyyyyxxx(yx)yxxxy = xyyyyxxx(xy)yxxxy
xyyyyxxx(yxyx)xyx = xyyyyxxx(xyxy)xyx
xyyyyxxx(yx)yxxyx = xyyyyxxx(xy)yxxyx
xyyyyxxxyx(yx)xyx = xyyyyxxxyx(xy)xyx
xyyyyxx(yxx)xxyyx = xyyyyxx(xxy)xxyyx
xyyyyxx(yx)xxxyyx = xyyyyxx(xy)xxxyyx
xyyyyxx(yxx)xyxyx = xyyyyxx(xxy)xyxyx
xyyyyxx(yxxxy)xyx = xyyyyxx(xxyyx)xyx
xyyyyxx(yx)xxyxyx = xyyyyxx(xy)xxyxyx
xyyyyxx(yxxxy)xyx = xyyyyxx(xyxyx)xyx
xyyyyxx(yxx)xyyxx = xyyyyxx(xxy)xyyxx
xyyyyxx(yx)xxyyxx = xyyyyxx(xy)xxyyxx
xyyyyxx(yxx)yxxxy = xyyyyxx(xxy)yxxxy
xyyyyxx(yx)xyxxxy = xyyyyxx(xy)xyxxxy
xyyyyxx(yxxyx)xyx = xyyyyxx(xxyxy)xyx
xyyyyxx(yxx)yxxyx = xyyyyxx(xxy)yxxyx
xyyyyxx(yxxyx)xyx = xyyyyxx(xyxxy)xyx
xyyyyxx(yx)xyxxyx = xyyyyxx(xy)xyxxyx
xyyyyxxyxx(yx)xyx = xyyyyxxyxx(xy)xyx
xyyyyxx(yx)xyxyxx = xyyyyxx(xy)xyxyxx
xyyyyxx(yx)xyyxxx = xyyyyxx(xy)xyyxxx
xyyyyxx(yx)yxxxxy = xyyyyxx(xy)yxxxxy
xyyyyxx(yx)yxxxyx = xyyyyxx(xy)yxxxyx
xyyyyxx(yx)yxxyxx = xyyyyxx(xy)yxxyxx
xyyyyxyxxx(yx)xyx = xyyyyxyxxx(xy)xyx
xyyyyxyxx(yx)xyxx = xyyyyxyxx(xy)xyxx
xyyyyx(yx)xyyxxxx = xyyyyx(xy)xyyxxxx
xyyyyx(yx)yxxxxxy = xyyyyx(xy)yxxxxxy
xyyyyx(yx)yxxxxyx = xyyyyx(xy)yxxxxyx
xyyyyx(yx)yxxxyxx = xyyyyx(xy)yxxxyxx
xyyyyx(yx)yxxyxxx = xyyyyx(xy)yxxyxxx
xyyyyx(yx)yxyxxxx = xyyyyx(xy)yxyxxxx
xyyyyyxxxx(yx)xyx = xyyyyyxxxx(xy)xyx
xyyyyyxxx(yxx)xyx = xyyyyyxxx(xxy)xyx
xyyyyyxxx(yx)xxyx = xyyyyyxxx(xy)xxyx
xyyyyyxxx(yx)xyxx = xyyyyyxxx(xy)xyxx
xyyyyyxx(yx)xyxxx = xyyyyyxx(xy)xyxxx
#  relations (9,6)
xxxxxyyx(yx)xyxyy = xxxxxyyx(xy)xyxyy
xxxxxyyx(yx)xyyxy = xxxxxyyx(xy)xyyxy
xxxxxyyx(yx)xyyyx = xxxxxyyx(xy)xyyyx
xxxxxyyx(yx)yxxyy = xxxxxyyx(xy)yxxyy
xxxxxyyyx(yx)xyyx = xxxxxyyyx(xy)xyyx
xxxxxyyyx(yx)yxxy = xxxxxyyyx(xy)yxxy
xxxxyxxxyy(yx)yxy = xxxxyxxxyy(xy)yxy
xxxxyxxy(yx)xyxyy = xxxxyxxy(xy)xyxyy
xxxxyxxy(yx)xyyxy = xxxxyxxy(xy)xyyxy
xxxxyxxy(yx)xyyyx = xxxxyxxy(xy)xyyyx
xxxxyxxy(yx)yxxyy = xxxxyxxy(xy)yxxyy
xxxxyx(yx)xxyyxyy = xxxxyx(xy)xxyyxyy
xxxxyx(yx)xxyyyxy = xxxxyx(xy)xxyyyxy
xxxxyx(yx)xxyyyyx = xxxxyx(xy)xxyyyyx
xxxxyxyyx(yx)xyyx = xxxxyxyyx(xy)xyyx
xxxxyxyyx(yx)yxxy = xxxxyxyyx(xy)yxxy
xxxxyxy(yx)yyxxxy = xxxxyxy(xy)yyxxxy
xxxxyyxxy(yx)xyyx = xxxxyyxxy(xy)xyyx
xxxxyyxxy(yx)yxxy = xxxxyyxxy(xy)yxxy
xxxxyyx(yx)xxyyyx = xxxxyyx(xy)xxyyyx
xxxxyyx(yx)xyxyyx = xxxxyyx(xy)xyxyyx
xxxxyyx(yxxy)xyyx = xxxxyyx(xyyx)xyyx
xxxxyyx(yx)xyyxxy = xxxxyyx(xy)xyyxxy
xxxxyyx(yxxy)yxxy = xxxxyyx(xyyx)yxxy
xxxxyyx(yx)xyyxyx = xxxxyyx(xy)xyyxyx
xxxxyyx(yx)xyyyxx = xxxxyyx(xy)xyyyxx
xxxxyyx(yx)yxxxyy = xxxxyyx(xy)yxxxyy
xxxxyyx(yx)yxxyxy = xxxxyyx(xy)yxxyxy
xxxxyyx(yxyx)xyyx = xxxxyyx(xyxy)xyyx
xxxxyyx(yx)yxxyyx = xxxxyyx(xy)yxxyyx
xxxxyyxyx(yx)xyyx = xxxxyyxyx(xy)xyyx
xxxxyyx(yxyx)yxxy = xxxxyyx(xyxy)yxxy
xxxxyyx(yx)yxyxxy = xxxxyyx(xy)yxyxxy
xxxxyyxyx(yx)yxxy = xxxxyyxyx(xy)yxxy
xxxxyyx(yx)yyxxxy = xxxxyyx(xy)yyxxxy
xxxxyyyxx(yx)xyxy = xxxxyyyxx(xy)xyxy
xxxxyyyxx(yx)xyyx = xxxxyyyxx(xy)xyyx
xxxxyyyxx(yx)yxxy = xxxxyyyxx(xy)yxxy
xxxxyyyx(yx)xyyxx = xxxxyyyx(xy)xyyxx
xxxxyyyx(yx)yxxxy = xxxxyyyx(xy)yxxxy
xxxxyyyx(yx)yxxyx = xxxxyyyx(xy)yxxyx
xxxxyyyyxx(yx)xyx = xxxxyyyyxx(xy)xyx
xxxyxxxxyy(yx)yxy = xxxyxxxxyy(xy)yxy
xxxyxxxy(yx)xyxyy = xxxyxxxy(xy)xyxyy
xxxyxxxy(yx)xyyxy = xxxyxxxy(xy)xyyxy
xxxyxxxy(yx)xyyyx = xxxyxxxy(xy)xyyyx
xxxyxxxy(yx)yxxyy = xxxyxxxy(xy)yxxyy
xxxyxxxyy(yx)xyyx = xxxyxxxyy(xy)xyyx
xxxyxxxyy(yx)yxxy = xxxyxxxyy(xy)yxxy
xxxyxxxyy(yx)yxyx = xxxyxxxyy(xy)yxyx
xxxyxxyxy(yx)xyyx = xxxyxxyxy(xy)xyyx
xxxyxxyxy(yx)yxxy = xxxyxxyxy(xy)yxxy
xxxyxxy(yx)xxyyyx = xxxyxxy(xy)xxyyyx
xxxyxxy(yx)xyxyyx = xxxyxxy(xy)xyxyyx
xxxyxxy(yxxy)xyyx = xxxyxxy(xyyx)xyyx
xxxyxxy(yx)xyyxxy = xxxyxxy(xy)xyyxxy
xxxyxxy(yxxy)yxxy = xxxyxxy(xyyx)yxxy
xxxyxxy(yx)xyyxyx = xxxyxxy(xy)xyyxyx
xxxyxxy(yx)xyyyxx = xxxyxxy(xy)xyyyxx
xxxyxxy(yx)yxxxyy = xxxyxxy(xy)yxxxyy
xxxyxxy(yx)yxxyxy = xxxyxxy(xy)yxxyxy
xxxyxxy(yxyx)xyyx = xxxyxxy(xyxy)xyyx
xxxyxxy(yx)yxxyyx = xxxyxxy(xy)yxxyyx
xxxyxxyyx(yx)xyyx = xxxyxxyyx(xy)xyyx
xxxyxxy(yxyx)yxxy = xxxyxxy(xyxy)yxxy
xxxyxxy(yx)yxyxxy = xxxyxxy(xy)yxyxxy
xxxyxxyyx(yx)yxxy = xxxyxxyyx(xy)yxxy
xxxyxxy(yx)yyxxxy = xxxyxxy(xy)yyxxxy
xxxyx(yx)xxxyyyyx = xxxyx(xy)xxxyyyyx
xxxyx(yx)xxyxyyyx = xxxyx(xy)xxyxyyyx
xxxyx(yx)xxyyxyyx = xxxyx(xy)xxyyxyyx
xxxyx(yx)xxyyyxxy = xxxyx(xy)xxyyyxxy
xxxyx(yx)xxyyyxyx = xxxyx(xy)xxyyyxyx
xxxyx(yx)xxyyyyxx = xxxyx(xy)xxyyyyxx
xxxyxyxxy(yx)xyyx = xxxyxyxxy(xy)xyyx
xxxyxyxxy(yx)yxxy = xxxyxyxxy(xy)yxxy
xxxyx(yx)yxxxxyyy = xxxyx(xy)yxxxxyyy
xxxyxyx(yx)xxyyyx = xxxyxyx(xy)xxyyyx
xxxyxyx(yx)yxxxyy = xxxyxyx(xy)yxxxyy
xxxyxyyx(yx)xyyxx = xxxyxyyx(xy)xyyxx
xxxyxyyx(yx)yxxxy = xxxyxyyx(xy)yxxxy
xxxyxyyx(yx)yxxyx = xxxyxyyx(xy)yxxyx
xxxyxy(yx)yyxxxxy = xxxyxy(xy)yyxxxxy
xxxyxy(yx)yyxxxyx = xxxyxy(xy)yyxxxyx
xxxyxyyyxx(yx)xyx = xxxyxyyyxx(xy)xyx
xxxyyxxxy(yx)xyyx = xxxyyxxxy(xy)xyyx
xxxyyxxxy(yx)yxxy = xxxyyxxxy(xy)yxxy
xxxyyxx(yx)xxyyxy = xxxyyxx(xy)xxyyxy
xxxyyxx(yx)xxyyyx = xxxyyxx(xy)xxyyyx
xxxyyxx(yx)xyxxyy = xxxyyxx(xy)xyxxyy
xxxyyxx(yx)yxxxyy = xxxyyxx(xy)yxxxyy
xxxyyxxy(yx)xyyxx = xxxyyxxy(xy)xyyxx
xxxyyxxy(yx)yxxxy = xxxyyxxy(xy)yxxxy
xxxyyxxy(yx)yxxyx = xxxyyxxy(xy)yxxyx
xxxyyx(yx)xxyyyxx = xxxyyx(xy)xxyyyxx
xxxyyx(yx)xyxyyxx = xxxyyx(xy)xyxyyxx
xxxyyx(yxxy)xyyxx = xxxyyx(xyyx)xyyxx
xxxyyx(yx)xyyxxxy = xxxyyx(xy)xyyxxxy
xxxyyx(yxxy)yxxxy = xxxyyx(xyyx)yxxxy
xxxyyx(yx)xyyxxyx = xxxyyx(xy)xyyxxyx
xxxyyx(yxxy)yxxyx = xxxyyx(xyyx)yxxyx
xxxyyx(yx)xyyxyxx = xxxyyx(xy)xyyxyxx
xxxyyx(yx)xyyyxxx = xxxyyx(xy)xyyyxxx
xxxyyx(yx)yxxxxyy = xxxyyx(xy)yxxxxyy
xxxyyx(yx)yxxxyxy = xxxyyx(xy)yxxxyxy
xxxyyx(yx)yxxxyyx = xxxyyx(xy)yxxxyyx
xxxyyx(yx)yxxyxxy = xxxyyx(xy)yxxyxxy
xxxyyx(yx)yxxyxyx = xxxyyx(xy)yxxyxyx
xxxyyx(yxyx)xyyxx = xxxyyx(xyxy)xyyxx
xxxyyx(yx)yxxyyxx = xxxyyx(xy)yxxyyxx
xxxyyxyx(yx)xyyxx = xxxyyxyx(xy)xyyxx
xxxyyx(yxyx)yxxxy = xxxyyx(xyxy)yxxxy
xxxyyx(yx)yxyxxxy = xxxyyx(xy)yxyxxxy
xxxyyxyx(yx)yxxxy = xxxyyxyx(xy)yxxxy
xxxyyx(yxyx)yxxyx = xxxyyx(xyxy)yxxyx
xxxyyx(yx)yxyxxyx = xxxyyx(xy)yxyxxyx
xxxyyxyx(yx)yxxyx = xxxyyxyx(xy)yxxyx
xxxyyx(yx)yyxxxxy = xxxyyx(xy)yyxxxxy
xxxyyx(yx)yyxxxyx = xxxyyx(xy)yyxxxyx
xxxyyxyyxx(yx)xyx = xxxyyxyyxx(xy)xyx
xxxyyyxx(yx)xxyyx = xxxyyyxx(xy)xxyyx
xxxyyyxx(yx)xyxxy = xxxyyyxx(xy)xyxxy
xxxyyyxx(yx)xyxyx = xxxyyyxx(xy)xyxyx
xxxyyyxx(yx)xyyxx = xxxyyyxx(xy)xyyxx
xxxyyyxx(yx)yxxxy = xxxyyyxx(xy)yxxxy
xxxyyyxx(yx)yxxyx = xxxyyyxx(xy)yxxyx
xxxyyyxyxx(yx)xyx = xxxyyyxyxx(xy)xyx
xxxyyyx(yx)xyyxxx = xxxyyyx(xy)xyyxxx
xxxyyyx(yx)yxxxxy = xxxyyyx(xy)yxxxxy
xxxyyyx(yx)yxxxyx = xxxyyyx(xy)yxxxyx
xxxyyyx(yx)yxxyxx = xxxyyyx(xy)yxxyxx
xxxyyyyxxx(yx)xyx = xxxyyyyxxx(xy)xyx
xxxyyyyxx(yx)xyxx = xxxyyyyxx(xy)xyxx
xxyxxxxxyy(yx)yxy = xxyxxxxxyy(xy)yxy
xxyxxxxy(yx)xyxyy = xxyxxxxy(xy)xyxyy
xxyxxxxy(yx)xyyxy = xxyxxxxy(xy)xyyxy
xxyxxxxy(yx)xyyyx = xxyxxxxy(xy)xyyyx
xxyxxxxy(yx)yxxyy = xxyxxxxy(xy)yxxyy
xxyxxxxyy(yx)xyyx = xxyxxxxyy(xy)xyyx
xxyxxxxyy(yx)yxxy = xxyxxxxyy(xy)yxxy
xxyxxxxyy(yx)yxyx = xxyxxxxyy(xy)yxyx
xxyxxxyxy(yx)xyyx = xxyxxxyxy(xy)xyyx
xxyxxxyxy(yx)yxxy = xxyxxxyxy(xy)yxxy
xxyxxxy(yx)xxyyxy = xxyxxxy(xy)xxyyxy
xxyxxxy(yx)xxyyyx = xxyxxxy(xy)xxyyyx
xxyxxxy(yx)xyxyxy = xxyxxxy(xy)xyxyxy
xxyxxxy(yx)xyxyyx = xxyxxxy(xy)xyxyyx
xxyxxxy(yxxy)xyyx = xxyxxxy(xyyx)xyyx
xxyxxxy(yx)xyyxxy = xxyxxxy(xy)xyyxxy
xxyxxxy(yxxy)yxxy = xxyxxxy(xyyx)yxxy
xxyxxxy(yx)xyyxyx = xxyxxxy(xy)xyyxyx
xxyxxxy(yx)xyyyxx = xxyxxxy(xy)xyyyxx
xxyxxxy(yx)yxxxyy = xxyxxxy(xy)yxxxyy
xxyxxxy(yx)yxxyxy = xxyxxxy(xy)yxxyxy
xxyxxxy(yxyx)xyyx = xxyxxxy(xyxy)xyyx
xxyxxxy(yx)yxxyyx = xxyxxxy(xy)yxxyyx
xxyxxxyyx(yx)xyyx = xxyxxxyyx(xy)xyyx
xxyxxxy(yxyx)yxxy = xxyxxxy(xyxy)yxxy
xxyxxxy(yx)yxyxxy = xxyxxxy(xy)yxyxxy
xxyxxxyyx(yx)yxxy = xxyxxxyyx(xy)yxxy
xxyxxxy(yx)yyxxxy = xxyxxxy(xy)yyxxxy
xxyxxxyy(yx)xyyxx = xxyxxxyy(xy)xyyxx
xxyxxxy(yyx)yxxxy = xxyxxxy(xyy)yxxxy
xxyxxxyy(yx)yxxxy = xxyxxxyy(xy)yxxxy
xxyxxxyy(yx)yxxyx = xxyxxxyy(xy)yxxyx
xxyxxxyy(yx)yxyxx = xxyxxxyy(xy)yxyxx
xxyxx(yx)xxxyyxyy = xxyxx(xy)xxxyyxyy
xxyxx(yx)xxxyyyxy = xxyxx(xy)xxxyyyxy
xxyxx(yx)xxxyyyyx = xxyxx(xy)xxxyyyyx
xxyxxyxxy(yx)xyyx = xxyxxyxxy(xy)xyyx
xxyxxyxxy(yx)yxxy = xxyxxyxxy(xy)yxxy
xxyxxyx(yx)xxyyxy = xxyxxyx(xy)xxyyxy
xxyxxyx(yx)xxyyyx = xxyxxyx(xy)xxyyyx
xxyxxyxy(yx)xyyxx = xxyxxyxy(xy)xyyxx
xxyxxyxy(yx)yxxxy = xxyxxyxy(xy)yxxxy
xxyxxyxy(yx)yxxyx = xxyxxyxy(xy)yxxyx
xxyxxy(yx)xxyyyxx = xxyxxy(xy)xxyyyxx
xxyxxy(yx)xyxyyxx = xxyxxy(xy)xyxyyxx
xxyxxy(yxxy)xyyxx = xxyxxy(xyyx)xyyxx
xxyxxy(yx)xyyxxxy = xxyxxy(xy)xyyxxxy
xxyxxy(yxxy)yxxxy = xxyxxy(xyyx)yxxxy
xxyxxy(yx)xyyxxyx = xxyxxy(xy)xyyxxyx
xxyxxy(yxxy)yxxyx = xxyxxy(xyyx)yxxyx
xxyxxy(yx)xyyxyxx = xxyxxy(xy)xyyxyxx
xxyxxy(yx)xyyyxxx = xxyxxy(xy)xyyyxxx
xxyxxy(yx)yxxxxyy = xxyxxy(xy)yxxxxyy
xxyxxy(yx)yxxxyxy = xxyxxy(xy)yxxxyxy
xxyxxy(yx)yxxxyyx = xxyxxy(xy)yxxxyyx
xxyxxy(yx)yxxyxxy = xxyxxy(xy)yxxyxxy
xxyxxy(yx)yxxyxyx = xxyxxy(xy)yxxyxyx
xxyxxy(yxyx)xyyxx = xxyxxy(xyxy)xyyxx
xxyxxy(yx)yxxyyxx = xxyxxy(xy)yxxyyxx
xxyxxyyx(yx)xyyxx = xxyxxyyx(xy)xyyxx
xxyxxy(yxyx)yxxxy = xxyxxy(xyxy)yxxxy
xxyxxy(yx)yxyxxxy = xxyxxy(xy)yxyxxxy
xxyxxyyx(yx)yxxxy = xxyxxyyx(xy)yxxxy
xxyxxy(yxyx)yxxyx = xxyxxy(xyxy)yxxyx
xxyxxy(yx)yxyxxyx = xxyxxy(xy)yxyxxyx
xxyxxyyx(yx)yxxyx = xxyxxyyx(xy)yxxyx
xxyxxy(yx)yyxxxxy = xxyxxy(xy)yyxxxxy
xxyxxy(yx)yyxxxyx = xxyxxy(xy)yyxxxyx
xxyxxyyyxx(yx)xyx = xxyxxyyyxx(xy)xyx
xxyx(yx)xxxyyyyxx = xxyx(xy)xxxyyyyxx
xxyx(yx)xxyxyyyxx = xxyx(xy)xxyxyyyxx
xxyxyxxxy(yx)xyyx = xxyxyxxxy(xy)xyyx
xxyxyxxxy(yx)yxxy = xxyxyxxxy(xy)yxxy
xxyx(yx)xxyyxyyxx = xxyx(xy)xxyyxyyxx
xxyx(yx)xxyyyxxxy = xxyx(xy)xxyyyxxxy
xxyx(yx)xxyyyxxyx = xxyx(xy)xxyyyxxyx
xxyx(yx)xxyyyxyxx = xxyx(xy)xxyyyxyxx
xxyx(yx)xxyyyyxxx = xxyx(xy)xxyyyyxxx
xxyxyxx(yx)xxyyxy = xxyxyxx(xy)xxyyxy
xxyxyxx(yx)xxyyyx = xxyxyxx(xy)xxyyyx
xxyxyxxy(yx)xyyxx = xxyxyxxy(xy)xyyxx
xxyxyxxy(yx)yxxxy = xxyxyxxy(xy)yxxxy
xxyxyxxy(yx)yxxyx = xxyxyxxy(xy)yxxyx
xxyx(yx)yxxxxxyyy = xxyx(xy)yxxxxxyyy
xxyx(yx)yxxxxyxyy = xxyx(xy)yxxxxyxyy
xxyx(yx)yxxxxyyxy = xxyx(xy)yxxxxyyxy
xxyx(yx)yxxxxyyyx = xxyx(xy)yxxxxyyyx
xxyxyx(yx)xxyyyxx = xxyxyx(xy)xxyyyxx
xxyxyx(yx)yxxxxyy = xxyxyx(xy)yxxxxyy
xxyxyx(yx)yxxxyxy = xxyxyx(xy)yxxxyxy
xxyxyx(yx)yxxxyyx = xxyxyx(xy)yxxxyyx
xxyxyxyx(yx)yxxxy = xxyxyxyx(xy)yxxxy
xxyxyyxx(yx)xxyyx = xxyxyyxx(xy)xxyyx
xxyxyyxx(yx)xyxxy = xxyxyyxx(xy)xyxxy
xxyxyyxx(yx)yxxxy = xxyxyyxx(xy)yxxxy
xxyxyyx(yx)xyyxxx = xxyxyyx(xy)xyyxxx
xxyxyyx(yx)yxxxxy = xxyxyyx(xy)yxxxxy
xxyxyyx(yx)yxxxyx = xxyxyyx(xy)yxxxyx
xxyxyyx(yx)yxxyxx = xxyxyyx(xy)yxxyxx
xxyxy(yx)yyxxxxxy = xxyxy(xy)yyxxxxxy
xxyxy(yx)yyxxxxyx = xxyxy(xy)yyxxxxyx
xxyxy(yx)yyxxxyxx = xxyxy(xy)yyxxxyxx
xxyxyyyxx(yx)xyxx = xxyxyyyxx(xy)xyxx
xxyyxxxxy(yx)xyxy = xxyyxxxxy(xy)xyxy
xxyyxxxxy(yx)xyyx = xxyyxxxxy(xy)xyyx
xxyyxxxxy(yx)yxxy = xxyyxxxxy(xy)yxxy
xxyyxxx(yx)xxyxyy = xxyyxxx(xy)xxyxyy
xxyyxxx(yx)xxyyxy = xxyyxxx(xy)xxyyxy
xxyyxxx(yx)xxyyyx = xxyyxxx(xy)xxyyyx
xxyyxxxy(yx)xxyyx = xxyyxxxy(xy)xxyyx
xxyyxxxy(yx)xyxyx = xxyyxxxy(xy)xyxyx
xxyyxxxy(yx)xyyxx = xxyyxxxy(xy)xyyxx
xxyyxxxy(yx)yxxxy = xxyyxxxy(xy)yxxxy
xxyyxxxy(yx)yxxyx = xxyyxxxy(xy)yxxyx
xxyyxx(yxx)xxyyxy = xxyyxx(xxy)xxyyxy
xxyyxx(yx)xxxyyxy = xxyyxx(xy)xxxyyxy
xxyyxx(yxx)xxyyyx = xxyyxx(xxy)xxyyyx
xxyyxx(yx)xxxyyyx = xxyyxx(xy)xxxyyyx
xxyyxx(yx)xxyxyxy = xxyyxx(xy)xxyxyxy
xxyyxx(yx)xxyxyyx = xxyyxx(xy)xxyxyyx
xxyyxx(yx)xxyyxxy = xxyyxx(xy)xxyyxxy
xxyyxx(yx)xxyyxyx = xxyyxx(xy)xxyyxyx
xxyyxx(yx)xxyyyxx = xxyyxx(xy)xxyyyxx
xxyyxx(yx)xyxxxyy = xxyyxx(xy)xyxxxyy
xxyyxx(yx)xyxxyxy = xxyyxx(xy)xyxxyxy
xxyyxx(yx)xyxxyyx = xxyyxx(xy)xyxxyyx
xxyyxx(yxxy)xxyyx = xxyyxx(xyyx)xxyyx
xxyyxx(yx)yxxxxyy = xxyyxx(xy)yxxxxyy
xxyyxx(yx)yxxxyxy = xxyyxx(xy)yxxxyxy
xxyyxx(yxyx)xxyyx = xxyyxx(xyxy)xxyyx
xxyyxx(yx)yxxxyyx = xxyyxx(xy)yxxxyyx
xxyyxxyx(yx)xxyyx = xxyyxxyx(xy)xxyyx
xxyyxxyx(yx)yxxxy = xxyyxxyx(xy)yxxxy
xxyyxxy(yx)xyyxxx = xxyyxxy(xy)xyyxxx
xxyyxxy(yx)yxxxxy = xxyyxxy(xy)yxxxxy
xxyyxxy(yx)yxxxyx = xxyyxxy(xy)yxxxyx
xxyyxxy(yx)yxxyxx = xxyyxxy(xy)yxxyxx
xxyyx(yx)xxyyyxxx = xxyyx(xy)xxyyyxxx
xxyyxyxx(yx)xxyyx = xxyyxyxx(xy)xxyyx
xxyyxyxx(yx)xyxxy = xxyyxyxx(xy)xyxxy
xxyyxyxx(yx)yxxxy = xxyyxyxx(xy)yxxxy
xxyyx(yx)xyxyyxxx = xxyyx(xy)xyxyyxxx
xxyyx(yxxy)xyyxxx = xxyyx(xyyx)xyyxxx
xxyyx(yx)xyyxxxxy = xxyyx(xy)xyyxxxxy
xxyyx(yxxy)yxxxxy = xxyyx(xyyx)yxxxxy
xxyyx(yx)xyyxxxyx = xxyyx(xy)xyyxxxyx
xxyyx(yxxy)yxxxyx = xxyyx(xyyx)yxxxyx
xxyyx(yx)xyyxxyxx = xxyyx(xy)xyyxxyxx
xxyyx(yxxy)yxxyxx = xxyyx(xyyx)yxxyxx
xxyyx(yx)xyyxyxxx = xxyyx(xy)xyyxyxxx
xxyyx(yx)xyyyxxxx = xxyyx(xy)xyyyxxxx
xxyyx(yx)yxxxxxyy = xxyyx(xy)yxxxxxyy
xxyyx(yx)yxxxxyxy = xxyyx(xy)yxxxxyxy
xxyyx(yx)yxxxxyyx = xxyyx(xy)yxxxxyyx
xxyyx(yx)yxxxyxxy = xxyyx(xy)yxxxyxxy
xxyyx(yx)yxxxyxyx = xxyyx(xy)yxxxyxyx
xxyyx(yx)yxxxyyxx = xxyyx(xy)yxxxyyxx
xxyyx(yx)yxxyxxxy = xxyyx(xy)yxxyxxxy
xxyyx(yx)yxxyxxyx = xxyyx(xy)yxxyxxyx
xxyyx(yx)yxxyxyxx = xxyyx(xy)yxxyxyxx
xxyyx(yxyx)xyyxxx = xxyyx(xyxy)xyyxxx
xxyyx(yx)yxxyyxxx = xxyyx(xy)yxxyyxxx
xxyyxyx(yx)xyyxxx = xxyyxyx(xy)xyyxxx
xxyyx(yxyx)yxxxxy = xxyyx(xyxy)yxxxxy
xxyyx(yx)yxyxxxxy = xxyyx(xy)yxyxxxxy
xxyyxyx(yx)yxxxxy = xxyyxyx(xy)yxxxxy
xxyyx(yxyx)yxxxyx = xxyyx(xyxy)yxxxyx
xxyyx(yx)yxyxxxyx = xxyyx(xy)yxyxxxyx
xxyyxyx(yx)yxxxyx = xxyyxyx(xy)yxxxyx
xxyyx(yxyx)yxxyxx = xxyyx(xyxy)yxxyxx
xxyyx(yx)yxyxxyxx = xxyyx(xy)yxyxxyxx
xxyyxyx(yx)yxxyxx = xxyyxyx(xy)yxxyxx
xxyyx(yx)yyxxxxxy = xxyyx(xy)yyxxxxxy
xxyyx(yx)yyxxxxyx = xxyyx(xy)yyxxxxyx
xxyyx(yx)yyxxxyxx = xxyyx(xy)yyxxxyxx
xxyyxyyxx(yx)xyxx = xxyyxyyxx(xy)xyxx
xxyyyxxxxy(yx)xyx = xxyyyxxxxy(xy)xyx
xxyyyxxx(yx)xxyxy = xxyyyxxx(xy)xxyxy
xxyyyxxx(yx)xxyyx = xxyyyxxx(xy)xxyyx
xxyyyxxx(yx)xyxxy = xxyyyxxx(xy)xyxxy
xxyyyxxx(yx)yxxxy = xxyyyxxx(xy)yxxxy
xxyyyxx(yxx)xxyyx = xxyyyxx(xxy)xxyyx
xxyyyxx(yx)xxxyyx = xxyyyxx(xy)xxxyyx
xxyyyxx(yx)xxyxyx = xxyyyxx(xy)xxyxyx
xxyyyxx(yx)xxyyxx = xxyyyxx(xy)xxyyxx
xxyyyxx(yxx)yxxxy = xxyyyxx(xxy)yxxxy
xxyyyxx(yx)xyxxxy = xxyyyxx(xy)xyxxxy
xxyyyxx(yx)xyxxyx = xxyyyxx(xy)xyxxyx
xxyyyxx(yx)xyxyxx = xxyyyxx(xy)xyxyxx
xxyyyxx(yx)xyyxxx = xxyyyxx(xy)xyyxxx
xxyyyxx(yx)yxxxxy = xxyyyxx(xy)yxxxxy
xxyyyxx(yx)yxxxyx = xxyyyxx(xy)yxxxyx
xxyyyxx(yx)yxxyxx = xxyyyxx(xy)yxxyxx
xxyyyxyxx(yx)xyxx = xxyyyxyxx(xy)xyxx
xxyyyx(yx)xyyxxxx = xxyyyx(xy)xyyxxxx
xxyyyx(yx)yxxxxxy = xxyyyx(xy)yxxxxxy
xxyyyx(yx)yxxxxyx = xxyyyx(xy)yxxxxyx
xxyyyx(yx)yxxxyxx = xxyyyx(xy)yxxxyxx
xxyyyx(yx)yxxyxxx = xxyyyx(xy)yxxyxxx
xxyyyyxxx(yx)xxyx = xxyyyyxxx(xy)xxyx
xxyyyyxxx(yx)xyxx = xxyyyyxxx(xy)xyxx
xxyyyyxx(yx)xyxxx = xxyyyyxx(xy)xyxxx
xyxxxxxxyy(yx)yxy = xyxxxxxxyy(xy)yxy
xyxxxxxy(yx)xyxyy = xyxxxxxy(xy)xyxyy
xyxxxxxy(yx)xyyxy = xyxxxxxy(xy)xyyxy
xyxxxxxy(yx)xyyyx = xyxxxxxy(xy)xyyyx
xyxxxxxy(yx)yxxyy = xyxxxxxy(xy)yxxyy
xyxxxxxyy(yx)xyyx = xyxxxxxyy(xy)xyyx
xyxxxxxyy(yx)yxxy = xyxxxxxyy(xy)yxxy
xyxxxxxyy(yx)yxyx = xyxxxxxyy(xy)yxyx
xyxxxxyxy(yx)xyyx = xyxxxxyxy(xy)xyyx
xyxxxxyxy(yx)yxxy = xyxxxxyxy(xy)yxxy
xyxxxxy(yx)xxyyxy = xyxxxxy(xy)xxyyxy
xyxxxxy(yx)xxyyyx = xyxxxxy(xy)xxyyyx
xyxxxxy(yx)xyxxyy = xyxxxxy(xy)xyxxyy
xyxxxxy(yx)xyxyxy = xyxxxxy(xy)xyxyxy
xyxxxxy(yx)xyxyyx = xyxxxxy(xy)xyxyyx
xyxxxxy(yxxy)xyyx = xyxxxxy(xyyx)xyyx
xyxxxxy(yx)xyyxxy = xyxxxxy(xy)xyyxxy
xyxxxxy(yxxy)yxxy = xyxxxxy(xyyx)yxxy
xyxxxxy(yx)xyyxyx = xyxxxxy(xy)xyyxyx
xyxxxxy(yx)xyyyxx = xyxxxxy(xy)xyyyxx
xyxxxxy(yx)yxxxyy = xyxxxxy(xy)yxxxyy
xyxxxxy(yx)yxxyxy = xyxxxxy(xy)yxxyxy
xyxxxxy(yxyx)xyyx = xyxxxxy(xyxy)xyyx
xyxxxxy(yx)yxxyyx = xyxxxxy(xy)yxxyyx
xyxxxxyyx(yx)xyyx = xyxxxxyyx(xy)xyyx
xyxxxxy(yxyx)yxxy = xyxxxxy(xyxy)yxxy
xyxxxxy(yx)yxyxxy = xyxxxxy(xy)yxyxxy
xyxxxxyyx(yx)yxxy = xyxxxxyyx(xy)yxxy
xyxxxxy(yx)yyxxxy = xyxxxxy(xy)yyxxxy
xyxxxxyy(yx)xyyxx = xyxxxxyy(xy)xyyxx
xyxxxxy(yyx)yxxxy = xyxxxxy(xyy)yxxxy
xyxxxxyy(yx)yxxxy = xyxxxxyy(xy)yxxxy
xyxxxxyy(yx)yxxyx = xyxxxxyy(xy)yxxyx
xyxxxxyy(yx)yxyxx = xyxxxxyy(xy)yxyxx
xyxxxyxxy(yx)xyyx = xyxxxyxxy(xy)xyyx
xyxxxyxxy(yx)yxxy = xyxxxyxxy(xy)yxxy
xyxxxyx(yx)xxyyxy = xyxxxyx(xy)xxyyxy
xyxxxyx(yx)xxyyyx = xyxxxyx(xy)xxyyyx
xyxxxyxy(yx)xyyxx = xyxxxyxy(xy)xyyxx
xyxxxyxy(yx)yxxxy = xyxxxyxy(xy)yxxxy
xyxxxyxy(yx)yxxyx = xyxxxyxy(xy)yxxyx
xyxxxy(yxx)xxyyyx = xyxxxy(xxy)xxyyyx
xyxxxy(yx)xxxyyyx = xyxxxy(xy)xxxyyyx
xyxxxy(yx)xxyxyyx = xyxxxy(xy)xxyxyyx
xyxxxy(yx)xxyyxxy = xyxxxy(xy)xxyyxxy
xyxxxy(yx)xxyyxyx = xyxxxy(xy)xxyyxyx
xyxxxy(yx)xxyyyxx = xyxxxy(xy)xxyyyxx
xyxxxy(yx)xyxxyyx = xyxxxy(xy)xyxxyyx
xyxxxy(yx)xyxyxxy = xyxxxy(xy)xyxyxxy
xyxxxy(yx)xyxyxyx = xyxxxy(xy)xyxyxyx
xyxxxy(yx)xyxyyxx = xyxxxy(xy)xyxyyxx
xyxxxy(yxxy)xyyxx = xyxxxy(xyyx)xyyxx
xyxxxy(yx)xyyxxxy = xyxxxy(xy)xyyxxxy
xyxxxy(yxxy)yxxxy = xyxxxy(xyyx)yxxxy
xyxxxy(yx)xyyxxyx = xyxxxy(xy)xyyxxyx
xyxxxy(yxxy)yxxyx = xyxxxy(xyyx)yxxyx
xyxxxy(yx)xyyxyxx = xyxxxy(xy)xyyxyxx
xyxxxy(yx)xyyyxxx = xyxxxy(xy)xyyyxxx
xyxxxy(yx)yxxxxyy = xyxxxy(xy)yxxxxyy
xyxxxy(yx)yxxxyxy = xyxxxy(xy)yxxxyxy
xyxxxy(yx)yxxxyyx = xyxxxy(xy)yxxxyyx
xyxxxy(yx)yxxyxxy = xyxxxy(xy)yxxyxxy
xyxxxy(yx)yxxyxyx = xyxxxy(xy)yxxyxyx
xyxxxy(yxyx)xyyxx = xyxxxy(xyxy)xyyxx
xyxxxy(yx)yxxyyxx = xyxxxy(xy)yxxyyxx
xyxxxyyx(yx)xyyxx = xyxxxyyx(xy)xyyxx
xyxxxy(yxyx)yxxxy = xyxxxy(xyxy)yxxxy
xyxxxy(yx)yxyxxxy = xyxxxy(xy)yxyxxxy
xyxxxyyx(yx)yxxxy = xyxxxyyx(xy)yxxxy
xyxxxy(yxyx)yxxyx = xyxxxy(xyxy)yxxyx
xyxxxy(yx)yxyxxyx = xyxxxy(xy)yxyxxyx
xyxxxyyx(yx)yxxyx = xyxxxyyx(xy)yxxyx
xyxxxy(yx)yyxxxxy = xyxxxy(xy)yyxxxxy
xyxxxy(yx)yyxxxyx = xyxxxy(xy)yyxxxyx
xyxxxyyyxx(yx)xyx = xyxxxyyyxx(xy)xyx
xyxxxyy(yx)xyyxxx = xyxxxyy(xy)xyyxxx
xyxxxy(yyx)yxxxxy = xyxxxy(xyy)yxxxxy
xyxxxyy(yx)yxxxxy = xyxxxyy(xy)yxxxxy
xyxxxy(yyx)yxxxyx = xyxxxy(xyy)yxxxyx
xyxxxyy(yx)yxxxyx = xyxxxyy(xy)yxxxyx
xyxxxyy(yx)yxxyxx = xyxxxyy(xy)yxxyxx
xyxxxyy(yx)yxyxxx = xyxxxyy(xy)yxyxxx
xyxx(yx)xxxxyyyxy = xyxx(xy)xxxxyyyxy
xyxx(yx)xxxxyyyyx = xyxx(xy)xxxxyyyyx
xyxx(yx)xxxyxyyxy = xyxx(xy)xxxyxyyxy
xyxx(yx)xxxyxyyyx = xyxx(xy)xxxyxyyyx
xyxx(yx)xxxyyxxyy = xyxx(xy)xxxyyxxyy
xyxx(yx)xxxyyxyxy = xyxx(xy)xxxyyxyxy
xyxx(yx)xxxyyxyyx = xyxx(xy)xxxyyxyyx
xyxx(yx)xxxyyyxxy = xyxx(xy)xxxyyyxxy
xyxx(yx)xxxyyyxyx = xyxx(xy)xxxyyyxyx
xyxx(yx)xxxyyyyxx = xyxx(xy)xxxyyyyxx
xyxxyxxxy(yx)xyyx = xyxxyxxxy(xy)xyyx
xyxxyxxxy(yx)yxxy = xyxxyxxxy(xy)yxxy
xyxxyxxy(yx)xyyxx = xyxxyxxy(xy)xyyxx
xyxxyxxy(yx)yxxxy = xyxxyxxy(xy)yxxxy
xyxxyxxy(yx)yxxyx = xyxxyxxy(xy)yxxyx
xyxxyx(yx)xxxyyyx = xyxxyx(xy)xxxyyyx
xyxxyx(yx)xxyxyyx = xyxxyx(xy)xxyxyyx
xyxxyx(yx)xxyyxxy = xyxxyx(xy)xxyyxxy
xyxxyx(yx)xxyyxyx = xyxxyx(xy)xxyyxyx
xyxxyx(yx)xxyyyxx = xyxxyx(xy)xxyyyxx
xyxxyx(yx)yxxxxyy = xyxxyx(xy)yxxxxyy
xyxxyxyx(yx)yxxxy = xyxxyxyx(xy)yxxxy
xyxxyxy(yx)xyyxxx = xyxxyxy(xy)xyyxxx
xyxxyxy(yx)yxxxxy = xyxxyxy(xy)yxxxxy
xyxxyxy(yx)yxxxyx = xyxxyxy(xy)yxxxyx
xyxxyxy(yx)yxxyxx = xyxxyxy(xy)yxxyxx
xyxxy(yx)xxyyyxxx = xyxxy(xy)xxyyyxxx
xyxxyyxx(yx)xxyyx = xyxxyyxx(xy)xxyyx
xyxxyyxx(yx)xyxxy = xyxxyyxx(xy)xyxxy
xyxxyyxx(yx)yxxxy = xyxxyyxx(xy)yxxxy
xyxxy(yx)xyxyyxxx = xyxxy(xy)xyxyyxxx
xyxxy(yxxy)xyyxxx = xyxxy(xyyx)xyyxxx
xyxxy(yx)xyyxxxxy = xyxxy(xy)xyyxxxxy
xyxxy(yxxy)yxxxxy = xyxxy(xyyx)yxxxxy
xyxxy(yx)xyyxxxyx = xyxxy(xy)xyyxxxyx
xyxxy(yxxy)yxxxyx = xyxxy(xyyx)yxxxyx
xyxxy(yx)xyyxxyxx = xyxxy(xy)xyyxxyxx
xyxxy(yxxy)yxxyxx = xyxxy(xyyx)yxxyxx
xyxxy(yx)xyyxyxxx = xyxxy(xy)xyyxyxxx
xyxxy(yx)xyyyxxxx = xyxxy(xy)xyyyxxxx
xyxxy(yx)yxxxxxyy = xyxxy(xy)yxxxxxyy
xyxxy(yx)yxxxxyxy = xyxxy(xy)yxxxxyxy
xyxxy(yx)yxxxxyyx = xyxxy(xy)yxxxxyyx
xyxxy(yx)yxxxyxxy = xyxxy(xy)yxxxyxxy
xyxxy(yx)yxxxyxyx = xyxxy(xy)yxxxyxyx
xyxxy(yx)yxxxyyxx = xyxxy(xy)yxxxyyxx
xyxxy(yx)yxxyxxxy = xyxxy(xy)yxxyxxxy
xyxxy(yx)yxxyxxyx = xyxxy(xy)yxxyxxyx
xyxxy(yx)yxxyxyxx = xyxxy(xy)yxxyxyxx
xyxxy(yxyx)xyyxxx = xyxxy(xyxy)xyyxxx
xyxxy(yx)yxxyyxxx = xyxxy(xy)yxxyyxxx
xyxxyyx(yx)xyyxxx = xyxxyyx(xy)xyyxxx
xyxxy(yxyx)yxxxxy = xyxxy(xyxy)yxxxxy
xyxxy(yx)yxyxxxxy = xyxxy(xy)yxyxxxxy
xyxxyyx(yx)yxxxxy = xyxxyyx(xy)yxxxxy
xyxxy(yxyx)yxxxyx = xyxxy(xyxy)yxxxyx
xyxxy(yx)yxyxxxyx = xyxxy(xy)yxyxxxyx
xyxxyyx(yx)yxxxyx = xyxxyyx(xy)yxxxyx
xyxxy(yxyx)yxxyxx = xyxxy(xyxy)yxxyxx
xyxxy(yx)yxyxxyxx = xyxxy(xy)yxyxxyxx
xyxxyyx(yx)yxxyxx = xyxxyyx(xy)yxxyxx
xyxxy(yx)yyxxxxxy = xyxxy(xy)yyxxxxxy
xyxxy(yx)yyxxxxyx = xyxxy(xy)yyxxxxyx
xyxxy(yx)yyxxxyxx = xyxxy(xy)yyxxxyxx
xyxxyyyxx(yx)xyxx = xyxxyyyxx(xy)xyxx
xyxyxxxxy(yx)xyxy = xyxyxxxxy(xy)xyxy
xyxyxxxxy(yx)xyyx = xyxyxxxxy(xy)xyyx
xyxyxxxxy(yx)yxxy = xyxyxxxxy(xy)yxxy
xyx(yx)xxxyyyyxxx = xyx(xy)xxxyyyyxxx
xyx(yx)xxyxyyyxxx = xyx(xy)xxyxyyyxxx
xyxyxxxy(yx)xxyyx = xyxyxxxy(xy)xxyyx
xyxyxxxy(yx)xyxyx = xyxyxxxy(xy)xyxyx
xyxyxxxy(yx)xyyxx = xyxyxxxy(xy)xyyxx
xyxyxxxy(yx)yxxxy = xyxyxxxy(xy)yxxxy
xyxyxxxy(yx)yxxyx = xyxyxxxy(xy)yxxyx
xyx(yx)xxyyxyyxxx = xyx(xy)xxyyxyyxxx
xyx(yx)xxyyyxxxxy = xyx(xy)xxyyyxxxxy
xyx(yx)xxyyyxxxyx = xyx(xy)xxyyyxxxyx
xyx(yx)xxyyyxxyxx = xyx(xy)xxyyyxxyxx
xyx(yx)xxyyyxyxxx = xyx(xy)xxyyyxyxxx
xyx(yx)xxyyyyxxxx = xyx(xy)xxyyyyxxxx
xyxyxx(yx)xxxyyxy = xyxyxx(xy)xxxyyxy
xyxyxx(yx)xxxyyyx = xyxyxx(xy)xxxyyyx
xyxyxx(yx)xxyxyxy = xyxyxx(xy)xxyxyxy
xyxyxx(yx)xxyxyyx = xyxyxx(xy)xxyxyyx
xyxyxx(yx)xxyyxxy = xyxyxx(xy)xxyyxxy
xyxyxx(yx)xxyyxyx = xyxyxx(xy)xxyyxyx
xyxyxx(yx)xxyyyxx = xyxyxx(xy)xxyyyxx
xyxyxx(yx)xyxxxyy = xyxyxx(xy)xyxxxyy
xyxyxx(yx)yxxxxyy = xyxyxx(xy)yxxxxyy
xyxyxxyx(yx)xxyyx = xyxyxxyx(xy)xxyyx
xyx(yx)xyyxxxxxyy = xyx(xy)xyyxxxxxyy
xyx(yxxy)yxxxxxyy = xyx(xyyx)yxxxxxyy
xyxyxxy(yx)xyyxxx = xyxyxxy(xy)xyyxxx
xyxyxxy(yx)yxxxxy = xyxyxxy(xy)yxxxxy
xyxyxxy(yx)yxxxyx = xyxyxxy(xy)yxxxyx
xyxyxxy(yx)yxxyxx = xyxyxxy(xy)yxxyxx
xyx(yx)yxxxxxxyyy = xyx(xy)yxxxxxxyyy
xyx(yx)yxxxxxyxyy = xyx(xy)yxxxxxyxyy
xyx(yx)yxxxxxyyxy = xyx(xy)yxxxxxyyxy
xyx(yx)yxxxxxyyyx = xyx(xy)yxxxxxyyyx
xyx(yx)yxxxxyxxyy = xyx(xy)yxxxxyxxyy
xyx(yx)yxxxxyxyxy = xyx(xy)yxxxxyxyxy
xyx(yx)yxxxxyxyyx = xyx(xy)yxxxxyxyyx
xyx(yx)yxxxxyyxxy = xyx(xy)yxxxxyyxxy
xyx(yx)yxxxxyyxyx = xyx(xy)yxxxxyyxyx
xyx(yx)yxxxxyyyxx = xyx(xy)yxxxxyyyxx
xyx(yx)yxxxyxxxyy = xyx(xy)yxxxyxxxyy
xyxyx(yx)xxyyyxxx = xyxyx(xy)xxyyyxxx
xyx(yx)yxxyxxxxyy = xyx(xy)yxxyxxxxyy
xyxyxyxx(yx)xxyyx = xyxyxyxx(xy)xxyyx
xyxyx(yx)xyyxxxxy = xyxyx(xy)xyyxxxxy
xyxyx(yxxy)yxxxxy = xyxyx(xyyx)yxxxxy
xyx(yxyx)yxxxxxyy = xyx(xyxy)yxxxxxyy
xyx(yx)yxyxxxxxyy = xyx(xy)yxyxxxxxyy
xyxyx(yx)yxxxxxyy = xyxyx(xy)yxxxxxyy
xyxyx(yx)yxxxxyxy = xyxyx(xy)yxxxxyxy
xyxyx(yx)yxxxxyyx = xyxyx(xy)yxxxxyyx
xyxyx(yx)yxxxyxxy = xyxyx(xy)yxxxyxxy
xyxyx(yx)yxxxyxyx = xyxyx(xy)yxxxyxyx
xyxyx(yx)yxxxyyxx = xyxyx(xy)yxxxyyxx
xyxyx(yx)yxxyxxxy = xyxyx(xy)yxxyxxxy
xyxyx(yxyx)yxxxxy = xyxyx(xyxy)yxxxxy
xyxyx(yx)yxyxxxxy = xyxyx(xy)yxyxxxxy
xyxyxyx(yx)yxxxxy = xyxyxyx(xy)yxxxxy
xyxyxyx(yx)yxxxyx = xyxyxyx(xy)yxxxyx
xyxyx(yx)yyxxxxxy = xyxyx(xy)yyxxxxxy
xyx(yx)yyxxxxxxyy = xyx(xy)yyxxxxxxyy
xyxyyxxxxy(yx)xyx = xyxyyxxxxy(xy)xyx
xyxyyxxx(yx)xxyxy = xyxyyxxx(xy)xxyxy
xyxyyxxx(yx)xxyyx = xyxyyxxx(xy)xxyyx
xyxyyxx(yxx)xxyyx = xyxyyxx(xxy)xxyyx
xyxyyxx(yx)xxxyyx = xyxyyxx(xy)xxxyyx
xyxyyxx(yx)xxyxyx = xyxyyxx(xy)xxyxyx
xyxyyxx(yx)xxyyxx = xyxyyxx(xy)xxyyxx
xyxyyxx(yx)xyxxxy = xyxyyxx(xy)xyxxxy
xyxyyxx(yx)xyxxyx = xyxyyxx(xy)xyxxyx
xyxyyxx(yx)yxxxxy = xyxyyxx(xy)yxxxxy
xyxyyxx(yx)yxxxyx = xyxyyxx(xy)yxxxyx
xyxyyx(yx)xyyxxxx = xyxyyx(xy)xyyxxxx
xyxyyx(yx)yxxxxxy = xyxyyx(xy)yxxxxxy
xyxyyx(yx)yxxxxyx = xyxyyx(xy)yxxxxyx
xyxyyx(yx)yxxxyxx = xyxyyx(xy)yxxxyxx
xyxyyx(yx)yxxyxxx = xyxyyx(xy)yxxyxxx
xyxy(yx)yyxxxxxxy = xyxy(xy)yyxxxxxxy
xyxy(yx)yyxxxxxyx = xyxy(xy)yyxxxxxyx
xyxy(yx)yyxxxxyxx = xyxy(xy)yyxxxxyxx
xyxy(yx)yyxxxyxxx = xyxy(xy)yyxxxyxxx
xyxyyyxxx(yx)xxyx = xyxyyyxxx(xy)xxyx
xyxyyyxx(yx)xyxxx = xyxyyyxx(xy)xyxxx
xyyxxxxxy(yx)xyxy = xyyxxxxxy(xy)xyxy
xyyxxxxxy(yx)xyyx = xyyxxxxxy(xy)xyyx
xyyxxxxxy(yx)yxxy = xyyxxxxxy(xy)yxxy
xyyxxxxy(yx)xxyyx = xyyxxxxy(xy)xxyyx
xyyxxxxy(yx)xyxxy = xyyxxxxy(xy)xyxxy
xyyxxxxy(yx)xyxyx = xyyxxxxy(xy)xyxyx
xyyxxxxy(yx)xyyxx = xyyxxxxy(xy)xyyxx
xyyxxxxy(yx)yxxxy = xyyxxxxy(xy)yxxxy
xyyxxxxy(yx)yxxyx = xyyxxxxy(xy)yxxyx
xyyxxx(yx)xxxyyxy = xyyxxx(xy)xxxyyxy
xyyxxx(yx)xxxyyyx = xyyxxx(xy)xxxyyyx
xyyxxx(yx)xxyxxyy = xyyxxx(xy)xxyxxyy
xyyxxx(yx)xxyxyxy = xyyxxx(xy)xxyxyxy
xyyxxx(yx)xxyxyyx = xyyxxx(xy)xxyxyyx
xyyxxx(yx)xxyyxxy = xyyxxx(xy)xxyyxxy
xyyxxx(yx)xxyyxyx = xyyxxx(xy)xxyyxyx
xyyxxx(yx)xxyyyxx = xyyxxx(xy)xxyyyxx
xyyxxx(yx)xyxxxyy = xyyxxx(xy)xyxxxyy
xyyxxx(yx)yxxxxyy = xyyxxx(xy)yxxxxyy
xyyxxxyx(yx)xxyyx = xyyxxxyx(xy)xxyyx
xyyxxxy(yx)xxyyxx = xyyxxxy(xy)xxyyxx
xyyxxxy(yx)xyxyxx = xyyxxxy(xy)xyxyxx
xyyxxxy(yx)xyyxxx = xyyxxxy(xy)xyyxxx
xyyxxxy(yx)yxxxxy = xyyxxxy(xy)yxxxxy
xyyxxxy(yx)yxxxyx = xyyxxxy(xy)yxxxyx
xyyxxxy(yx)yxxyxx = xyyxxxy(xy)yxxyxx
xyyxx(yxx)xxxyyyx = xyyxx(xxy)xxxyyyx
xyyxx(yx)xxxxyyyx = xyyxx(xy)xxxxyyyx
xyyxx(yxx)xxyxyyx = xyyxx(xxy)xxyxyyx
xyyxx(yx)xxxyxyyx = xyyxx(xy)xxxyxyyx
xyyxx(yxx)xxyyxxy = xyyxx(xxy)xxyyxxy
xyyxx(yx)xxxyyxxy = xyyxx(xy)xxxyyxxy
xyyxx(yxx)xxyyxyx = xyyxx(xxy)xxyyxyx
xyyxx(yx)xxxyyxyx = xyyxx(xy)xxxyyxyx
xyyxx(yxx)xxyyyxx = xyyxx(xxy)xxyyyxx
xyyxx(yx)xxxyyyxx = xyyxx(xy)xxxyyyxx
xyyxx(yx)xxyxxyyx = xyyxx(xy)xxyxxyyx
xyyxx(yxxxy)xxyyx = xyyxx(xyxyx)xxyyx
xyyxx(yx)xxyxyxxy = xyyxx(xy)xxyxyxxy
xyyxx(yx)xxyxyxyx = xyyxx(xy)xxyxyxyx
xyyxx(yx)xxyxyyxx = xyyxx(xy)xxyxyyxx
xyyxx(yx)xxyyxxxy = xyyxx(xy)xxyyxxxy
xyyxx(yx)xxyyxxyx = xyyxx(xy)xxyyxxyx
xyyxx(yx)xxyyxyxx = xyyxx(xy)xxyyxyxx
xyyxx(yx)xxyyyxxx = xyyxx(xy)xxyyyxxx
xyyxx(yxx)yxxxxyy = xyyxx(xxy)yxxxxyy
xyyxx(yx)xyxxxxyy = xyyxx(xy)xyxxxxyy
xyyxx(yx)xyxxxyxy = xyyxx(xy)xyxxxyxy
xyyxx(yxxyx)xxyyx = xyyxx(xyxxy)xxyyx
xyyxx(yx)xyxxxyyx = xyyxx(xy)xyxxxyyx
xyyxxyxx(yx)xxyyx = xyyxxyxx(xy)xxyyx
xyyxx(yx)xyxxyxxy = xyyxx(xy)xyxxyxxy
xyyxx(yx)xyxxyxyx = xyyxx(xy)xyxxyxyx
xyyxx(yx)xyxxyyxx = xyyxx(xy)xyxxyyxx
xyyxx(yxxy)xxyyxx = xyyxx(xyyx)xxyyxx
xyyxx(yx)xyxyxxxy = xyyxx(xy)xyxyxxxy
xyyxx(yx)xyyxxxxy = xyyxx(xy)xyyxxxxy
xyyxx(yxxy)yxxxxy = xyyxx(xyyx)yxxxxy
xyyxx(yx)yxxxxxyy = xyyxx(xy)yxxxxxyy
xyyxx(yx)yxxxxyxy = xyyxx(xy)yxxxxyxy
xyyxx(yx)yxxxxyyx = xyyxx(xy)yxxxxyyx
xyyxx(yx)yxxxyxxy = xyyxx(xy)yxxxyxxy
xyyxx(yx)yxxxyxyx = xyyxx(xy)yxxxyxyx
xyyxx(yxyx)xxyyxx = xyyxx(xyxy)xxyyxx
xyyxx(yx)yxxxyyxx = xyyxx(xy)yxxxyyxx
xyyxxyx(yx)xxyyxx = xyyxxyx(xy)xxyyxx
xyyxx(yx)yxxyxxxy = xyyxx(xy)yxxyxxxy
xyyxx(yxyx)yxxxxy = xyyxx(xyxy)yxxxxy
xyyxx(yx)yxyxxxxy = xyyxx(xy)yxyxxxxy
xyyxxyx(yx)yxxxxy = xyyxxyx(xy)yxxxxy
xyyxxyx(yx)yxxxyx = xyyxxyx(xy)yxxxyx
xyyxx(yx)yyxxxxxy = xyyxx(xy)yyxxxxxy
xyyxxy(yx)xyyxxxx = xyyxxy(xy)xyyxxxx
xyyxx(yyx)yxxxxxy = xyyxx(xyy)yxxxxxy
xyyxxy(yx)yxxxxxy = xyyxxy(xy)yxxxxxy
xyyxxy(yx)yxxxxyx = xyyxxy(xy)yxxxxyx
xyyxxy(yx)yxxxyxx = xyyxxy(xy)yxxxyxx
xyyxxy(yx)yxxyxxx = xyyxxy(xy)yxxyxxx
xyyxyxxxxy(yx)xyx = xyyxyxxxxy(xy)xyx
xyyxyxxx(yx)xxyxy = xyyxyxxx(xy)xxyxy
xyyxyxxx(yx)xxyyx = xyyxyxxx(xy)xxyyx
xyyx(yx)xxyyyxxxx = xyyx(xy)xxyyyxxxx
xyyxyxx(yxx)xxyyx = xyyxyxx(xxy)xxyyx
xyyxyxx(yx)xxxyyx = xyyxyxx(xy)xxxyyx
xyyxyxx(yx)xxyxyx = xyyxyxx(xy)xxyxyx
xyyxyxx(yx)xxyyxx = xyyxyxx(xy)xxyyxx
xyyxyxx(yx)xyxxxy = xyyxyxx(xy)xyxxxy
xyyxyxx(yx)xyxxyx = xyyxyxx(xy)xyxxyx
xyyxyxx(yx)yxxxxy = xyyxyxx(xy)yxxxxy
xyyxyxx(yx)yxxxyx = xyyxyxx(xy)yxxxyx
xyyx(yx)xyxyyxxxx = xyyx(xy)xyxyyxxxx
xyyx(yxxy)xyyxxxx = xyyx(xyyx)xyyxxxx
xyyx(yxx)yyxxxxxy = xyyx(xxy)yyxxxxxy
xyyx(yx)xyyxxxxxy = xyyx(xy)xyyxxxxxy
xyyx(yxxy)yxxxxxy = xyyx(xyyx)yxxxxxy
xyyx(yx)xyyxxxxyx = xyyx(xy)xyyxxxxyx
xyyx(yxxy)yxxxxyx = xyyx(xyyx)yxxxxyx
xyyx(yx)xyyxxxyxx = xyyx(xy)xyyxxxyxx
xyyx(yxxy)yxxxyxx = xyyx(xyyx)yxxxyxx
xyyx(yx)xyyxxyxxx = xyyx(xy)xyyxxyxxx
xyyx(yxxy)yxxyxxx = xyyx(xyyx)yxxyxxx
xyyx(yx)xyyxyxxxx = xyyx(xy)xyyxyxxxx
xyyx(yx)xyyyxxxxx = xyyx(xy)xyyyxxxxx
xyyx(yx)yxxxxxxyy = xyyx(xy)yxxxxxxyy
xyyx(yx)yxxxxxyxy = xyyx(xy)yxxxxxyxy
xyyx(yx)yxxxxxyyx = xyyx(xy)yxxxxxyyx
xyyx(yx)yxxxxyxxy = xyyx(xy)yxxxxyxxy
xyyx(yx)yxxxxyxyx = xyyx(xy)yxxxxyxyx
xyyx(yx)yxxxxyyxx = xyyx(xy)yxxxxyyxx
xyyx(yx)yxxxyxxxy = xyyx(xy)yxxxyxxxy
xyyx(yx)yxxxyxxyx = xyyx(xy)yxxxyxxyx
xyyx(yx)yxxxyxyxx = xyyx(xy)yxxxyxyxx
xyyx(yx)yxxxyyxxx = xyyx(xy)yxxxyyxxx
xyyx(yx)yxxyxxxxy = xyyx(xy)yxxyxxxxy
xyyx(yx)yxxyxxxyx = xyyx(xy)yxxyxxxyx
xyyx(yx)yxxyxxyxx = xyyx(xy)yxxyxxyxx
xyyx(yx)yxxyxyxxx = xyyx(xy)yxxyxyxxx
xyyx(yxyx)xyyxxxx = xyyx(xyxy)xyyxxxx
xyyx(yx)yxxyyxxxx = xyyx(xy)yxxyyxxxx
xyyxyx(yx)xyyxxxx = xyyxyx(xy)xyyxxxx
xyyx(yxyx)yxxxxxy = xyyx(xxyy)yxxxxxy
xyyx(yxyx)yxxxxxy = xyyx(xyxy)yxxxxxy
xyyx(yx)yxyxxxxxy = xyyx(xy)yxyxxxxxy
xyyxyx(yx)yxxxxxy = xyyxyx(xy)yxxxxxy
xyyx(yxyx)yxxxxyx = xyyx(xyxy)yxxxxyx
xyyx(yx)yxyxxxxyx = xyyx(xy)yxyxxxxyx
xyyxyx(yx)yxxxxyx = xyyxyx(xy)yxxxxyx
xyyx(yxyx)yxxxyxx = xyyx(xyxy)yxxxyxx
xyyx(yx)yxyxxxyxx = xyyx(xy)yxyxxxyxx
xyyxyx(yx)yxxxyxx = xyyxyx(xy)yxxxyxx
xyyx(yxyx)yxxyxxx = xyyx(xyxy)yxxyxxx
xyyx(yx)yxyxxyxxx = xyyx(xy)yxyxxyxxx
xyyxyx(yx)yxxyxxx = xyyxyx(xy)yxxyxxx
xyyx(yx)yyxxxxxxy = xyyx(xy)yyxxxxxxy
xyyx(yx)yyxxxxxyx = xyyx(xy)yyxxxxxyx
xyyx(yx)yyxxxxyxx = xyyx(xy)yyxxxxyxx
xyyx(yx)yyxxxyxxx = xyyx(xy)yyxxxyxxx
xyyxyyxxx(yx)xxyx = xyyxyyxxx(xy)xxyx
xyyxyyxx(yx)xyxxx = xyyxyyxx(xy)xyxxx
xyyyxxxxxy(yx)xyx = xyyyxxxxxy(xy)xyx
xyyyxxxx(yx)xxyxy = xyyyxxxx(xy)xxyxy
xyyyxxxx(yx)xxyyx = xyyyxxxx(xy)xxyyx
xyyyxxxxy(yx)xyxx = xyyyxxxxy(xy)xyxx
xyyyxxx(yxx)xxyyx = xyyyxxx(xxy)xxyyx
xyyyxxx(yx)xxxyyx = xyyyxxx(xy)xxxyyx
xyyyxxx(yx)xxyxxy = xyyyxxx(xy)xxyxxy
xyyyxxx(yx)xxyxyx = xyyyxxx(xy)xxyxyx
xyyyxxx(yx)xxyyxx = xyyyxxx(xy)xxyyxx
xyyyxxx(yx)xyxxxy = xyyyxxx(xy)xyxxxy
xyyyxxx(yx)xyxxyx = xyyyxxx(xy)xyxxyx
xyyyxxx(yx)yxxxxy = xyyyxxx(xy)yxxxxy
xyyyxxx(yx)yxxxyx = xyyyxxx(xy)yxxxyx
xyyyxx(yxx)xxyyxx = xyyyxx(xxy)xxyyxx
xyyyxx(yx)xxxyyxx = xyyyxx(xy)xxxyyxx
xyyyxx(yx)xxyxyxx = xyyyxx(xy)xxyxyxx
xyyyxx(yx)xxyyxxx = xyyyxx(xy)xxyyxxx
xyyyxx(yxx)yxxxxy = xyyyxx(xxy)yxxxxy
xyyyxx(yx)xyxxxxy = xyyyxx(xy)xyxxxxy
xyyyxx(yxx)yxxxyx = xyyyxx(xxy)yxxxyx
xyyyxx(yx)xyxxxyx = xyyyxx(xy)xyxxxyx
xyyyxx(yx)xyxxyxx = xyyyxx(xy)xyxxyxx
xyyyxx(yx)xyxyxxx = xyyyxx(xy)xyxyxxx
xyyyxx(yx)xyyxxxx = xyyyxx(xy)xyyxxxx
xyyyxx(yx)yxxxxxy = xyyyxx(xy)yxxxxxy
xyyyxx(yx)yxxxxyx = xyyyxx(xy)yxxxxyx
xyyyxx(yx)yxxxyxx = xyyyxx(xy)yxxxyxx
xyyyxx(yx)yxxyxxx = xyyyxx(xy)yxxyxxx
xyyyxyxxx(yx)xxyx = xyyyxyxxx(xy)xxyx
xyyyxyxx(yx)xyxxx = xyyyxyxx(xy)xyxxx
xyyyx(yx)xyyxxxxx = xyyyx(xy)xyyxxxxx
xyyyx(yx)yxxxxxxy = xyyyx(xy)yxxxxxxy
xyyyx(yx)yxxxxxyx = xyyyx(xy)yxxxxxyx
xyyyx(yx)yxxxxyxx = xyyyx(xy)yxxxxyxx
xyyyx(yx)yxxxyxxx = xyyyx(xy)yxxxyxxx
xyyyx(yx)yxxyxxxx = xyyyx(xy)yxxyxxxx
xyyyyxxxx(yx)xxyx = xyyyyxxxx(xy)xxyx
xyyyyxxx(yx)xxyxx = xyyyyxxx(xy)xxyxx
xyyyyxxx(yx)xyxxx = xyyyyxxx(xy)xyxxx
xyyyyxx(yx)xyxxxx = xyyyyxx(xy)xyxxxx
#  relations (10,5)
xxxxxxyyx(yx)xyyx = xxxxxxyyx(xy)xyyx
xxxxxxyyx(yx)yxxy = xxxxxxyyx(xy)yxxy
xxxxxyxxy(yx)xyyx = xxxxxyxxy(xy)xyyx
xxxxxyxxy(yx)yxxy = xxxxxyxxy(xy)yxxy
xxxxxyx(yx)xxyyyx = xxxxxyx(xy)xxyyyx
xxxxxyyx(yx)xyyxx = xxxxxyyx(xy)xyyxx
xxxxxyyx(yx)yxxxy = xxxxxyyx(xy)yxxxy
xxxxxyyx(yx)yxxyx = xxxxxyyx(xy)yxxyx
xxxxxyyyxx(yx)xyx = xxxxxyyyxx(xy)xyx
xxxxyxxxy(yx)xyxy = xxxxyxxxy(xy)xyxy
xxxxyxxxy(yx)xyyx = xxxxyxxxy(xy)xyyx
xxxxyxxxy(yx)yxxy = xxxxyxxxy(xy)yxxy
xxxxyxxy(yx)xyyxx = xxxxyxxy(xy)xyyxx
xxxxyxxy(yx)yxxxy = xxxxyxxy(xy)yxxxy
xxxxyxxy(yx)yxxyx = xxxxyxxy(xy)yxxyx
xxxxyx(yx)xxyyyxx = xxxxyx(xy)xxyyyxx
xxxxyx(yx)yxxxxyy = xxxxyx(xy)yxxxxyy
xxxxyxyx(yx)yxxxy = xxxxyxyx(xy)yxxxy
xxxxyyxx(yx)xxyyx = xxxxyyxx(xy)xxyyx
xxxxyyxx(yx)xyxxy = xxxxyyxx(xy)xyxxy
xxxxyyxx(yx)yxxxy = xxxxyyxx(xy)yxxxy
xxxxyyx(yx)xyyxxx = xxxxyyx(xy)xyyxxx
xxxxyyx(yx)yxxxxy = xxxxyyx(xy)yxxxxy
xxxxyyx(yx)yxxxyx = xxxxyyx(xy)yxxxyx
xxxxyyx(yx)yxxyxx = xxxxyyx(xy)yxxyxx
xxxxyyyxx(yx)xyxx = xxxxyyyxx(xy)xyxx
xxxyxxxxy(yx)xyxy = xxxyxxxxy(xy)xyxy
xxxyxxxxy(yx)xyyx = xxxyxxxxy(xy)xyyx
xxxyxxxxy(yx)yxxy = xxxyxxxxy(xy)yxxy
xxxyxxxy(yx)xxyyx = xxxyxxxy(xy)xxyyx
xxxyxxxy(yx)xyxyx = xxxyxxxy(xy)xyxyx
xxxyxxxy(yx)xyyxx = xxxyxxxy(xy)xyyxx
xxxyxxxy(yx)yxxxy = xxxyxxxy(xy)yxxxy
xxxyxxxy(yx)yxxyx = xxxyxxxy(xy)yxxyx
xxxyxx(yx)xxxyyxy = xxxyxx(xy)xxxyyxy
xxxyxx(yx)xxxyyyx = xxxyxx(xy)xxxyyyx
xxxyxxyx(yx)xxyyx = xxxyxxyx(xy)xxyyx
xxxyxxy(yx)xyyxxx = xxxyxxy(xy)xyyxxx
xxxyxxy(yx)yxxxxy = xxxyxxy(xy)yxxxxy
xxxyxxy(yx)yxxxyx = xxxyxxy(xy)yxxxyx
xxxyxxy(yx)yxxyxx = xxxyxxy(xy)yxxyxx
xxxyx(yx)xxyyyxxx = xxxyx(xy)xxyyyxxx
xxxyxyxx(yx)xxyyx = xxxyxyxx(xy)xxyyx
xxxyx(yx)yxxxxxyy = xxxyx(xy)yxxxxxyy
xxxyx(yx)yxxxxyxy = xxxyx(xy)yxxxxyxy
xxxyx(yx)yxxxxyyx = xxxyx(xy)yxxxxyyx
xxxyxyx(yx)yxxxxy = xxxyxyx(xy)yxxxxy
xxxyxyx(yx)yxxxyx = xxxyxyx(xy)yxxxyx
xxxyyxxxxy(yx)xyx = xxxyyxxxxy(xy)xyx
xxxyyxxx(yx)xxyxy = xxxyyxxx(xy)xxyxy
xxxyyxxx(yx)xxyyx = xxxyyxxx(xy)xxyyx
xxxyyxx(yxx)xxyyx = xxxyyxx(xxy)xxyyx
xxxyyxx(yx)xxxyyx = xxxyyxx(xy)xxxyyx
xxxyyxx(yx)xxyxyx = xxxyyxx(xy)xxyxyx
xxxyyxx(yx)xxyyxx = xxxyyxx(xy)xxyyxx
xxxyyxx(yx)xyxxxy = xxxyyxx(xy)xyxxxy
xxxyyxx(yx)xyxxyx = xxxyyxx(xy)xyxxyx
xxxyyxx(yx)yxxxxy = xxxyyxx(xy)yxxxxy
xxxyyxx(yx)yxxxyx = xxxyyxx(xy)yxxxyx
xxxyyx(yx)xyyxxxx = xxxyyx(xy)xyyxxxx
xxxyyx(yx)yxxxxxy = xxxyyx(xy)yxxxxxy
xxxyyx(yx)yxxxxyx = xxxyyx(xy)yxxxxyx
xxxyyx(yx)yxxxyxx = xxxyyx(xy)yxxxyxx
xxxyyx(yx)yxxyxxx = xxxyyx(xy)yxxyxxx
xxxyyyxxx(yx)xxyx = xxxyyyxxx(xy)xxyx
xxxyyyxx(yx)xyxxx = xxxyyyxx(xy)xyxxx
xxyxxxxxy(yx)xyxy = xxyxxxxxy(xy)xyxy
xxyxxxxxy(yx)xyyx = xxyxxxxxy(xy)xyyx
xxyxxxxxy(yx)yxxy = xxyxxxxxy(xy)yxxy
xxyxxxxy(yx)xxyyx = xxyxxxxy(xy)xxyyx
xxyxxxxy(yx)xyxxy = xxyxxxxy(xy)xyxxy
xxyxxxxy(yx)xyxyx = xxyxxxxy(xy)xyxyx
xxyxxxxy(yx)xyyxx = xxyxxxxy(xy)xyyxx
xxyxxxxy(yx)yxxxy = xxyxxxxy(xy)yxxxy
xxyxxxxy(yx)yxxyx = xxyxxxxy(xy)yxxyx
xxyxxxyx(yx)xxyyx = xxyxxxyx(xy)xxyyx
xxyxxxy(yx)xxyyxx = xxyxxxy(xy)xxyyxx
xxyxxxy(yx)xyxyxx = xxyxxxy(xy)xyxyxx
xxyxxxy(yx)xyyxxx = xxyxxxy(xy)xyyxxx
xxyxxxy(yx)yxxxxy = xxyxxxy(xy)yxxxxy
xxyxxxy(yx)yxxxyx = xxyxxxy(xy)yxxxyx
xxyxxxy(yx)yxxyxx = xxyxxxy(xy)yxxyxx
xxyxx(yx)xxxxyyyx = xxyxx(xy)xxxxyyyx
xxyxx(yx)xxxyxyyx = xxyxx(xy)xxxyxyyx
xxyxx(yx)xxxyyxxy = xxyxx(xy)xxxyyxxy
xxyxx(yx)xxxyyxyx = xxyxx(xy)xxxyyxyx
xxyxx(yx)xxxyyyxx = xxyxx(xy)xxxyyyxx
xxyxxyx(yx)xxyyxx = xxyxxyx(xy)xxyyxx
xxyxxyx(yx)yxxxxy = xxyxxyx(xy)yxxxxy
xxyxxy(yx)xyyxxxx = xxyxxy(xy)xyyxxxx
xxyxxy(yx)yxxxxxy = xxyxxy(xy)yxxxxxy
xxyxxy(yx)yxxxxyx = xxyxxy(xy)yxxxxyx
xxyxxy(yx)yxxxyxx = xxyxxy(xy)yxxxyxx
xxyxxy(yx)yxxyxxx = xxyxxy(xy)yxxyxxx
xxyxyxxxxy(yx)xyx = xxyxyxxxxy(xy)xyx
xxyx(yx)xxyyyxxxx = xxyx(xy)xxyyyxxxx
xxyxyxx(yx)xxxyyx = xxyxyxx(xy)xxxyyx
xxyxyxx(yx)xxyxyx = xxyxyxx(xy)xxyxyx
xxyxyxx(yx)xxyyxx = xxyxyxx(xy)xxyyxx
xxyxyxx(yx)xyxxxy = xxyxyxx(xy)xyxxxy
xxyxyxx(yx)yxxxxy = xxyxyxx(xy)yxxxxy
xxyx(yx)xyyxxxxxy = xxyx(xy)xyyxxxxxy
xxyx(yxxy)yxxxxxy = xxyx(xyyx)yxxxxxy
xxyx(yx)yxxxxxxyy = xxyx(xy)yxxxxxxyy
xxyx(yx)yxxxxxyxy = xxyx(xy)yxxxxxyxy
xxyx(yx)yxxxxxyyx = xxyx(xy)yxxxxxyyx
xxyx(yx)yxxxxyxxy = xxyx(xy)yxxxxyxxy
xxyx(yx)yxxxxyxyx = xxyx(xy)yxxxxyxyx
xxyx(yx)yxxxxyyxx = xxyx(xy)yxxxxyyxx
xxyx(yx)yxxxyxxxy = xxyx(xy)yxxxyxxxy
xxyx(yx)yxxyxxxxy = xxyx(xy)yxxyxxxxy
xxyx(yxyx)yxxxxxy = xxyx(xyxy)yxxxxxy
xxyx(yx)yxyxxxxxy = xxyx(xy)yxyxxxxxy
xxyxyx(yx)yxxxxxy = xxyxyx(xy)yxxxxxy
xxyxyx(yx)yxxxxyx = xxyxyx(xy)yxxxxyx
xxyxyx(yx)yxxxyxx = xxyxyx(xy)yxxxyxx
xxyx(yx)yyxxxxxxy = xxyx(xy)yyxxxxxxy
xxyxyyxxx(yx)xxyx = xxyxyyxxx(xy)xxyx
xxyyxxxxxy(yx)xyx = xxyyxxxxxy(xy)xyx
xxyyxxxxy(yx)xyxx = xxyyxxxxy(xy)xyxx
xxyyxxx(yx)xxxyyx = xxyyxxx(xy)xxxyyx
xxyyxxx(yx)xxyxxy = xxyyxxx(xy)xxyxxy
xxyyxxx(yx)xxyxyx = xxyyxxx(xy)xxyxyx
xxyyxxx(yx)xxyyxx = xxyyxxx(xy)xxyyxx
xxyyxxx(yx)xyxxxy = xxyyxxx(xy)xyxxxy
xxyyxxx(yx)yxxxxy = xxyyxxx(xy)yxxxxy
xxyyxx(yxx)xxyyxx = xxyyxx(xxy)xxyyxx
xxyyxx(yx)xxxyyxx = xxyyxx(xy)xxxyyxx
xxyyxx(yx)xxyxyxx = xxyyxx(xy)xxyxyxx
xxyyxx(yx)xxyyxxx = xxyyxx(xy)xxyyxxx
xxyyxx(yxx)yxxxxy = xxyyxx(xxy)yxxxxy
xxyyxx(yx)xyxxxxy = xxyyxx(xy)xyxxxxy
xxyyxx(yx)xyxxxyx = xxyyxx(xy)xyxxxyx
xxyyxx(yx)xyxxyxx = xxyyxx(xy)xyxxyxx
xxyyxx(yx)yxxxxxy = xxyyxx(xy)yxxxxxy
xxyyxx(yx)yxxxxyx = xxyyxx(xy)yxxxxyx
xxyyxx(yx)yxxxyxx = xxyyxx(xy)yxxxyxx
xxyyxyxxx(yx)xxyx = xxyyxyxxx(xy)xxyx
xxyyx(yx)xyyxxxxx = xxyyx(xy)xyyxxxxx
xxyyx(yx)yxxxxxxy = xxyyx(xy)yxxxxxxy
xxyyx(yx)yxxxxxyx = xxyyx(xy)yxxxxxyx
xxyyx(yx)yxxxxyxx = xxyyx(xy)yxxxxyxx
xxyyx(yx)yxxxyxxx = xxyyx(xy)yxxxyxxx
xxyyx(yx)yxxyxxxx = xxyyx(xy)yxxyxxxx
xxyyyxxxx(yx)xxyx = xxyyyxxxx(xy)xxyx
xxyyyxxx(yx)xxyxx = xxyyyxxx(xy)xxyxx
xxyyyxx(yx)xyxxxx = xxyyyxx(xy)xyxxxx
xyxxxxxxy(yx)xyxy = xyxxxxxxy(xy)xyxy
xyxxxxxxy(yx)xyyx = xyxxxxxxy(xy)xyyx
xyxxxxxxy(yx)yxxy = xyxxxxxxy(xy)yxxy
xyxxxxxxyy(yx)xyx = xyxxxxxxyy(xy)xyx
xyxxxxxyxy(yx)xyx = xyxxxxxyxy(xy)xyx
xyxxxxxy(yx)xxyyx = xyxxxxxy(xy)xxyyx
xyxxxxxy(yx)xyxxy = xyxxxxxy(xy)xyxxy
xyxxxxxy(yx)xyxyx = xyxxxxxy(xy)xyxyx
xyxxxxxy(yxxy)xyx = xyxxxxxy(xyyx)xyx
xyxxxxxy(yx)xyyxx = xyxxxxxy(xy)xyyxx
xyxxxxxy(yx)yxxxy = xyxxxxxy(xy)yxxxy
xyxxxxxy(yxyx)xyx = xyxxxxxy(xyxy)xyx
xyxxxxxy(yx)yxxyx = xyxxxxxy(xy)yxxyx
xyxxxxxyyx(yx)xyx = xyxxxxxyyx(xy)xyx
xyxxxxyxxy(yx)xyx = xyxxxxyxxy(xy)xyx
xyxxxxyx(yx)xxyyx = xyxxxxyx(xy)xxyyx
xyxxxxy(yxx)xxyyx = xyxxxxy(xxy)xxyyx
xyxxxxy(yx)xxxyyx = xyxxxxy(xy)xxxyyx
xyxxxxy(yx)xxyxyx = xyxxxxy(xy)xxyxyx
xyxxxxy(yx)xxyyxx = xyxxxxy(xy)xxyyxx
xyxxxxy(yx)xyxxxy = xyxxxxy(xy)xyxxxy
xyxxxxy(yx)xyxxyx = xyxxxxy(xy)xyxxyx
xyxxxxy(yx)xyxyxx = xyxxxxy(xy)xyxyxx
xyxxxxy(yx)xyyxxx = xyxxxxy(xy)xyyxxx
xyxxxxy(yx)yxxxxy = xyxxxxy(xy)yxxxxy
xyxxxxy(yx)yxxxyx = xyxxxxy(xy)yxxxyx
xyxxxxy(yx)yxxyxx = xyxxxxy(xy)yxxyxx
xyxxx(yx)xxxxyyxy = xyxxx(xy)xxxxyyxy
xyxxx(yx)xxxxyyyx = xyxxx(xy)xxxxyyyx
xyxxxyxxxy(yx)xyx = xyxxxyxxxy(xy)xyx
xyxxxyx(yx)xxxyyx = xyxxxyx(xy)xxxyyx
xyxxxyx(yx)xxyxyx = xyxxxyx(xy)xxyxyx
xyxxxyx(yx)xxyyxx = xyxxxyx(xy)xxyyxx
xyxxxyx(yx)xyxxxy = xyxxxyx(xy)xyxxxy
xyxxxyx(yx)yxxxxy = xyxxxyx(xy)yxxxxy
xyxxxy(yx)xxyyxxx = xyxxxy(xy)xxyyxxx
xyxxxy(yx)xyxyxxx = xyxxxy(xy)xyxyxxx
xyxxxy(yx)xyyxxxx = xyxxxy(xy)xyyxxxx
xyxxxy(yx)yxxxxxy = xyxxxy(xy)yxxxxxy
xyxxxy(yx)yxxxxyx = xyxxxy(xy)yxxxxyx
xyxxxy(yx)yxxxyxx = xyxxxy(xy)yxxxyxx
xyxxxy(yx)yxxyxxx = xyxxxy(xy)yxxyxxx
xyxx(yxx)xxxxyyyx = xyxx(xxy)xxxxyyyx
xyxx(yx)xxxxxyyyx = xyxx(xy)xxxxxyyyx
xyxx(yx)xxxxyxyyx = xyxx(xy)xxxxyxyyx
xyxx(yx)xxxxyyxyx = xyxx(xy)xxxxyyxyx
xyxx(yx)xxxxyyyxx = xyxx(xy)xxxxyyyxx
xyxx(yx)xxxyxxyyx = xyxx(xy)xxxyxxyyx
xyxx(yx)xxxyxyxyx = xyxx(xy)xxxyxyxyx
xyxx(yxxxxyxy)xyx = xyxx(xyxxxyyx)xyx
xyxx(yx)xxxyxyyxx = xyxx(xy)xxxyxyyxx
xyxx(yx)xxxyyxxxy = xyxx(xy)xxxyyxxxy
xyxx(yxxxxyyx)xyx = xyxx(xyxxxyxy)xyx
xyxx(yx)xxxyyxxyx = xyxx(xy)xxxyyxxyx
xyxxyxxxxy(yx)xyx = xyxxyxxxxy(xy)xyx
xyxx(yx)xxxyyxyxx = xyxx(xy)xxxyyxyxx
xyxx(yx)xxxyyyxxx = xyxx(xy)xxxyyyxxx
xyxx(yx)xyxxxxxyy = xyxx(xy)xyxxxxxyy
xyxxyxx(yx)xxxyyx = xyxxyxx(xy)xxxyyx
xyxx(yx)yxxxxxxyy = xyxx(xy)yxxxxxxyy
xyxxyx(yx)xxyyxxx = xyxxyx(xy)xxyyxxx
xyxxyx(yx)yxxxxxy = xyxxyx(xy)yxxxxxy
xyxxyx(yx)yxxxxyx = xyxxyx(xy)yxxxxyx
xyxxyyxxx(yx)xxyx = xyxxyyxxx(xy)xxyx
xyxxy(yx)xyyxxxxx = xyxxy(xy)xyyxxxxx
xyxxy(yx)yxxxxxxy = xyxxy(xy)yxxxxxxy
xyxxy(yx)yxxxxxyx = xyxxy(xy)yxxxxxyx
xyxxy(yx)yxxxxyxx = xyxxy(xy)yxxxxyxx
xyxxy(yx)yxxxyxxx = xyxxy(xy)yxxxyxxx
xyxxy(yx)yxxyxxxx = xyxxy(xy)yxxyxxxx
xyxyxxxxxy(yx)xyx = xyxyxxxxxy(xy)xyx
xyxyxxxxy(yx)xyxx = xyxyxxxxy(xy)xyxx
xyxyxxx(yx)xxxyyx = xyxyxxx(xy)xxxyyx
xyx(yx)xxyyyxxxxx = xyx(xy)xxyyyxxxxx
xyxyxx(yx)xxxyyxx = xyxyxx(xy)xxxyyxx
xyxyxx(yx)xxyxyxx = xyxyxx(xy)xxyxyxx
xyxyxx(yx)xxyyxxx = xyxyxx(xy)xxyyxxx
xyxyxx(yx)xyxxxxy = xyxyxx(xy)xyxxxxy
xyxyxx(yx)xyxxxyx = xyxyxx(xy)xyxxxyx
xyxyxx(yx)yxxxxxy = xyxyxx(xy)yxxxxxy
xyxyxx(yx)yxxxxyx = xyxyxx(xy)yxxxxyx
xyx(yx)xyyxxxxxxy = xyx(xy)xyyxxxxxxy
xyx(yxxy)yxxxxxxy = xyx(xyyx)yxxxxxxy
xyx(yx)xyyxxxxxyx = xyx(xy)xyyxxxxxyx
xyx(yxxy)yxxxxxyx = xyx(xyyx)yxxxxxyx
xyx(yx)yxxxxxxxyy = xyx(xy)yxxxxxxxyy
xyx(yx)yxxxxxxyxy = xyx(xy)yxxxxxxyxy
xyx(yx)yxxxxxxyyx = xyx(xy)yxxxxxxyyx
xyx(yx)yxxxxxyxxy = xyx(xy)yxxxxxyxxy
xyx(yx)yxxxxxyxyx = xyx(xy)yxxxxxyxyx
xyx(yx)yxxxxxyyxx = xyx(xy)yxxxxxyyxx
xyx(yx)yxxxxyxxxy = xyx(xy)yxxxxyxxxy
xyx(yx)yxxxxyxxyx = xyx(xy)yxxxxyxxyx
xyx(yxyxxxxy)xxyx = xyx(xyyxxxyx)xxyx
xyx(yx)yxxxxyxyxx = xyx(xy)yxxxxyxyxx
xyx(yx)yxxxxyyxxx = xyx(xy)yxxxxyyxxx
xyx(yx)yxxxyxxxxy = xyx(xy)yxxxyxxxxy
xyx(yxyxxxyx)xxyx = xyx(xyyxxxxy)xxyx
xyx(yx)yxxxyxxxyx = xyx(xy)yxxxyxxxyx
xyxyxyxxx(yx)xxyx = xyxyxyxxx(xy)xxyx
xyx(yx)yxxyxxxxxy = xyx(xy)yxxyxxxxxy
xyx(yx)yxxyxxxxyx = xyx(xy)yxxyxxxxyx
xyx(yxyx)yxxxxxxy = xyx(xyxy)yxxxxxxy
xyx(yx)yxyxxxxxxy = xyx(xy)yxyxxxxxxy
xyxyx(yx)yxxxxxxy = xyxyx(xy)yxxxxxxy
xyx(yxyx)yxxxxxyx = xyx(xyxy)yxxxxxyx
xyx(yx)yxyxxxxxyx = xyx(xy)yxyxxxxxyx
xyxyx(yx)yxxxxxyx = xyxyx(xy)yxxxxxyx
xyxyx(yx)yxxxxyxx = xyxyx(xy)yxxxxyxx
xyxyx(yx)yxxxyxxx = xyxyx(xy)yxxxyxxx
xyx(yx)yyxxxxxxxy = xyx(xy)yyxxxxxxxy
xyx(yx)yyxxxxxxyx = xyx(xy)yyxxxxxxyx
xyxyyxxxx(yx)xxyx = xyxyyxxxx(xy)xxyx
xyxyyxxx(yx)xxyxx = xyxyyxxx(xy)xxyxx
xyyxxxxxxy(yx)xyx = xyyxxxxxxy(xy)xyx
xyyxxxxxy(yx)xyxx = xyyxxxxxy(xy)xyxx
xyyxxxx(yx)xxxyxy = xyyxxxx(xy)xxxyxy
xyyxxxx(yx)xxxyyx = xyyxxxx(xy)xxxyyx
xyyxxxxy(yx)xyxxx = xyyxxxxy(xy)xyxxx
xyyxxx(yxx)xxxyyx = xyyxxx(xxy)xxxyyx
xyyxxx(yx)xxxxyyx = xyyxxx(xy)xxxxyyx
xyyxxx(yx)xxxyxyx = xyyxxx(xy)xxxyxyx
xyyxxx(yx)xxxyyxx = xyyxxx(xy)xxxyyxx
xyyxxx(yx)xxyxxxy = xyyxxx(xy)xxyxxxy
xyyxxx(yx)xxyxxyx = xyyxxx(xy)xxyxxyx
xyyxxx(yx)xxyxyxx = xyyxxx(xy)xxyxyxx
xyyxxx(yx)xxyyxxx = xyyxxx(xy)xxyyxxx
xyyxxx(yx)xyxxxxy = xyyxxx(xy)xyxxxxy
xyyxxx(yx)xyxxxyx = xyyxxx(xy)xyxxxyx
xyyxxx(yx)yxxxxxy = xyyxxx(xy)yxxxxxy
xyyxxx(yx)yxxxxyx = xyyxxx(xy)yxxxxyx
xyyxx(yxx)xxyyxxx = xyyxx(xxy)xxyyxxx
xyyxx(yx)xxxyyxxx = xyyxx(xy)xxxyyxxx
xyyxxyxxx(yx)xxyx = xyyxxyxxx(xy)xxyx
xyyxx(yx)xxyxyxxx = xyyxx(xy)xxyxyxxx
xyyxx(yx)xxyyxxxx = xyyxx(xy)xxyyxxxx
xyyxx(yxx)yxxxxxy = xyyxx(xxy)yxxxxxy
xyyxx(yx)xyxxxxxy = xyyxx(xy)xyxxxxxy
xyyxx(yxx)yxxxxyx = xyyxx(xxy)yxxxxyx
xyyxx(yx)xyxxxxyx = xyyxx(xy)xyxxxxyx
xyyxx(yx)xyxxxyxx = xyyxx(xy)xyxxxyxx
xyyxx(yx)xyxxyxxx = xyyxx(xy)xyxxyxxx
xyyxx(yx)yxxxxxxy = xyyxx(xy)yxxxxxxy
xyyxx(yx)yxxxxxyx = xyyxx(xy)yxxxxxyx
xyyxx(yx)yxxxxyxx = xyyxx(xy)yxxxxyxx
xyyxx(yx)yxxxyxxx = xyyxx(xy)yxxxyxxx
xyyxyxxxx(yx)xxyx = xyyxyxxxx(xy)xxyx
xyyxyxxx(yx)xxyxx = xyyxyxxx(xy)xxyxx
xyyx(yx)xyyxxxxxx = xyyx(xy)xyyxxxxxx
xyyx(yx)yxxxxxxxy = xyyx(xy)yxxxxxxxy
xyyx(yx)yxxxxxxyx = xyyx(xy)yxxxxxxyx
xyyx(yx)yxxxxxyxx = xyyx(xy)yxxxxxyxx
xyyx(yx)yxxxxyxxx = xyyx(xy)yxxxxyxxx
xyyx(yx)yxxxyxxxx = xyyx(xy)yxxxyxxxx
xyyx(yx)yxxyxxxxx = xyyx(xy)yxxyxxxxx
xyyyxxxxx(yx)xxyx = xyyyxxxxx(xy)xxyx
xyyyxxxx(yxx)xxyx = xyyyxxxx(xxy)xxyx
xyyyxxxx(yx)xxxyx = xyyyxxxx(xy)xxxyx
xyyyxxxx(yx)xxyxx = xyyyxxxx(xy)xxyxx
xyyyxxx(yx)xxyxxx = xyyyxxx(xy)xxyxxx
xyyyxx(yx)xyxxxxx = xyyyxx(xy)xyxxxxx
#  relations (11,4)
xxxxxyx(yx)yxxxxy = xxxxxyx(xy)yxxxxy
xxxxyxxxxy(yx)xyx = xxxxyxxxxy(xy)xyx
xxxxyxx(yx)xxxyyx = xxxxyxx(xy)xxxyyx
xxxxyx(yx)yxxxxxy = xxxxyx(xy)yxxxxxy
xxxxyx(yx)yxxxxyx = xxxxyx(xy)yxxxxyx
xxxxyyxxx(yx)xxyx = xxxxyyxxx(xy)xxyx
xxxyxxxxxy(yx)xyx = xxxyxxxxxy(xy)xyx
xxxyxxxxy(yx)xyxx = xxxyxxxxy(xy)xyxx
xxxyxx(yx)xxxyyxx = xxxyxx(xy)xxxyyxx
xxxyx(yx)yxxxxxxy = xxxyx(xy)yxxxxxxy
xxxyx(yx)yxxxxxyx = xxxyx(xy)yxxxxxyx
xxxyx(yx)yxxxxyxx = xxxyx(xy)yxxxxyxx
xxxyyxxx(yx)xxyxx = xxxyyxxx(xy)xxyxx
xxyxxxxxxy(yx)xyx = xxyxxxxxxy(xy)xyx
xxyxxxxxy(yx)xyxx = xxyxxxxxy(xy)xyxx
xxyxxxxy(yx)xyxxx = xxyxxxxy(xy)xyxxx
xxyxxx(yx)xxxxyyx = xxyxxx(xy)xxxxyyx
xxyxx(yx)xxxyyxxx = xxyxx(xy)xxxyyxxx
xxyxx(yx)xyxxxxxy = xxyxx(xy)xyxxxxxy
xxyxx(yx)yxxxxxxy = xxyxx(xy)yxxxxxxy
xxyx(yx)yxxxxxxxy = xxyx(xy)yxxxxxxxy
xxyx(yx)yxxxxxxyx = xxyx(xy)yxxxxxxyx
xxyx(yx)yxxxxxyxx = xxyx(xy)yxxxxxyxx
xxyx(yx)yxxxxyxxx = xxyx(xy)yxxxxyxxx
xxyyxxxx(yx)xxxyx = xxyyxxxx(xy)xxxyx
xxyyxxx(yx)xxyxxx = xxyyxxx(xy)xxyxxx
xyxxxxxxxy(yx)xyx = xyxxxxxxxy(xy)xyx
xyxxxxxxy(yx)xxyx = xyxxxxxxy(xy)xxyx
xyxxxxxxy(yx)xyxx = xyxxxxxxy(xy)xyxx
xyxxxxxyx(yx)xxyx = xyxxxxxyx(xy)xxyx
xyxxxxxy(yx)xyxxx = xyxxxxxy(xy)xyxxx
xyxxxxy(yx)xyxxxx = xyxxxxy(xy)xyxxxx
xyxxx(yx)xxxxxyyx = xyxxx(xy)xxxxxyyx
xyxxx(yx)xxxxyxyx = xyxxx(xy)xxxxyxyx
xyxxx(yx)xxxxyyxx = xyxxx(xy)xxxxyyxx
xyxx(yx)xxxyyxxxx = xyxx(xy)xxxyyxxxx
xyxx(yx)xyxxxxxxy = xyxx(xy)xyxxxxxxy
xyxx(yx)xyxxxxxyx = xyxx(xy)xyxxxxxyx
xyxx(yx)yxxxxxxxy = xyxx(xy)yxxxxxxxy
xyxx(yx)yxxxxxxyx = xyxx(xy)yxxxxxxyx
xyxyxxxx(yx)xxxyx = xyxyxxxx(xy)xxxyx
xyx(yx)yxxxxxxxxy = xyx(xy)yxxxxxxxxy
xyx(yx)yxxxxxxxyx = xyx(xy)yxxxxxxxyx
xyx(yx)yxxxxxxyxx = xyx(xy)yxxxxxxyxx
xyx(yx)yxxxxxyxxx = xyx(xy)yxxxxxyxxx
xyx(yx)yxxxxyxxxx = xyx(xy)yxxxxyxxxx
xyyxxxxx(yx)xxxyx = xyyxxxxx(xy)xxxyx
xyyxxxx(yx)xxxyxx = xyyxxxx(xy)xxxyxx
xyyxxx(yx)xxyxxxx = xyyxxx(xy)xxyxxxx
