# triangular relations for n = 13
#  relations (4,9)
xyyyyx(yx)yxyyy = xyyyyx(xy)yxyyy
xyyyyyx(yx)yxyy = xyyyyyx(xy)yxyy
xyyyyyyx(yx)yxy = xyyyyyyx(xy)yxy
#  relations (5,8)
xxyyyyx(yx)yxyy = xxyyyyx(xy)yxyy
xxyyyyyx(yx)yxy = xxyyyyyx(xy)yxy
xyxxyyy(yx)yyxy = xyxxyyy(xy)yyxy
xyxy(yx)xyyyyxy = xyxy(xy)xyyyyxy
xyxy(yx)xyyyyyx = xyxy(xy)xyyyyyx
xyxyy(yx)yyyxxy = xyxyy(xy)yyyxxy
xyxyyyyx(yx)yxy = xyxyyyyx(xy)yxy
xyyx(yx)xyyxyyy = xyyx(xy)xyyxyyy
xyyx(yx)xyyyxyy = xyyx(xy)xyyyxyy
xyyx(yx)xyyyyxy = xyyx(xy)xyyyyxy
xyyx(yx)xyyyyyx = xyyx(xy)xyyyyyx
xyyx(yx)yxxyyyy = xyyx(xy)yxxyyyy
xyyxy(yx)xyyyyx = xyyxy(xy)xyyyyx
xyyxy(yx)yyxxyy = xyyxy(xy)yyxxyy
xyyyx(yx)xyyxyy = xyyyx(xy)xyyxyy
xyyyx(yx)xyyyxy = xyyyx(xy)xyyyxy
xyyyx(yx)xyyyyx = xyyyx(xy)xyyyyx
xyyyx(yx)yxxyyy = xyyyx(xy)yxxyyy
xyyyx(yx)yxyxyy = xyyyx(xy)yxyxyy
xyyyx(yx)yyxxyy = xyyyx(xy)yyxxyy
xyyyxy(yx)yyxxy = xyyyxy(xy)yyxxy
xyyyyx(yx)xyyxy = xyyyyx(xy)xyyxy
xyyyyx(yx)xyyyx = xyyyyx(xy)xyyyx
xyyyyx(yx)yxxyy = xyyyyx(xy)yxxyy
xyyyyx(yx)yxyxy = xyyyyx(xy)yxyxy
xyyyyx(yx)yxyyx = xyyyyx(xy)yxyyx
xyyyyx(yx)yyxxy = xyyyyx(xy)yyxxy
xyyyyyx(yx)xyyx = xyyyyyx(xy)xyyx
xyyyyyx(yx)yxxy = xyyyyyx(xy)yxxy
xyyyyyx(yx)yxyx = xyyyyyx(xy)yxyx
#  relations (6,7)
xxxyyyyx(yx)yxy = xxxyyyyx(xy)yxy
xxyxxyy(yx)yxyy = xxyxxyy(xy)yxyy
xxyxy(yx)xyyyyx = xxyxy(xy)xyyyyx
xxyyx(yx)xyyxyy = xxyyx(xy)xyyxyy
xxyyx(yx)xyyyxy = xxyyx(xy)xyyyxy
xxyyx(yx)xyyyyx = xxyyx(xy)xyyyyx
xxyyx(yx)yxxyyy = xxyyx(xy)yxxyyy
xxyyxy(yx)yyxxy = xxyyxy(xy)yyxxy
xxyyyx(yx)xyyxy = xxyyyx(xy)xyyxy
xxyyyx(yx)xyyyx = xxyyyx(xy)xyyyx
xxyyyx(yx)yxxyy = xxyyyx(xy)yxxyy
xxyyyx(yx)yxyxy = xxyyyx(xy)yxyxy
xxyyyx(yx)yyxxy = xxyyyx(xy)yyxxy
xxyyyyx(yx)xyyx = xxyyyyx(xy)xyyx
xxyyyyx(yx)yxxy = xxyyyyx(xy)yxxy
xxyyyyx(yx)yxyx = xxyyyyx(xy)yxyx
xyxxxyy(yx)yxyy = xyxxxyy(xy)yxyy
xyxxy(yx)xyyxyy = xyxxy(xy)xyyxyy
xyxxy(yx)xyyyxy = xyxxy(xy)xyyyxy
xyxxy(yx)xyyyyx = xyxxy(xy)xyyyyx
xyxxy(yx)yxxyyy = xyxxy(xy)yxxyyy
xyxxyy(yx)xyyyx = xyxxyy(xy)xyyyx
xyxxyy(yx)yxyyx = xyxxyy(xy)yxyyx
xyxxyy(yx)yyxxy = xyxxyy(xy)yyxxy
xyx(yx)xxyyyxyy = xyx(xy)xxyyyxyy
xyx(yx)xxyyyyxy = xyx(xy)xxyyyyxy
xyx(yx)xxyyyyyx = xyx(xy)xxyyyyyx
xyxyxy(yx)xyyyx = xyxyxy(xy)xyyyx
xyxy(yx)xyyyyxx = xyxy(xy)xyyyyxx
xyxyyx(yx)xyyxy = xyxyyx(xy)xyyxy
xyxyyx(yx)xyyyx = xyxyyx(xy)xyyyx
xyxyyx(yx)yxxyy = xyxyyx(xy)yxxyy
xyxy(yx)yyxxxyy = xyxy(xy)yyxxxyy
xyxyyyx(yx)xyyx = xyxyyyx(xy)xyyx
xyxyyyx(yx)yxxy = xyxyyyx(xy)yxxy
xyyxxxyy(yx)yxy = xyyxxxyy(xy)yxy
xyyxxy(yx)xyyxy = xyyxxy(xy)xyyxy
xyyxxy(yx)xyyyx = xyyxxy(xy)xyyyx
xyyxxy(yx)yxxyy = xyyxxy(xy)yxxyy
xyyx(yx)xxyyyxy = xyyx(xy)xxyyyxy
xyyx(yx)xxyyyyx = xyyx(xy)xxyyyyx
xyyx(yx)xyxyyxy = xyyx(xy)xyxyyxy
xyyx(yxxy)xyyxy = xyyx(xyyx)xyyxy
xyyx(yx)xyxyyyx = xyyx(xy)xyxyyyx
xyyx(yxxy)xyyyx = xyyx(xyyx)xyyyx
xyyx(yx)xyyxxyy = xyyx(xy)xyyxxyy
xyyx(yxxy)yxxyy = xyyx(xyyx)yxxyy
xyyx(yx)xyyxyxy = xyyx(xy)xyyxyxy
xyyx(yx)xyyxyyx = xyyx(xy)xyyxyyx
xyyx(yx)xyyyxxy = xyyx(xy)xyyyxxy
xyyx(yx)xyyyxyx = xyyx(xy)xyyyxyx
xyyx(yx)xyyyyxx = xyyx(xy)xyyyyxx
xyyx(yx)yxxxyyy = xyyx(xy)yxxxyyy
xyyx(yx)yxxyxyy = xyyx(xy)yxxyxyy
xyyx(yxyx)xyyxy = xyyx(xyxy)xyyxy
xyyx(yx)yxxyyxy = xyyx(xy)yxxyyxy
xyyxyx(yx)xyyxy = xyyxyx(xy)xyyxy
xyyx(yxyx)xyyyx = xyyx(xyxy)xyyyx
xyyx(yx)yxxyyyx = xyyx(xy)yxxyyyx
xyyxyx(yx)xyyyx = xyyxyx(xy)xyyyx
xyyx(yxyx)yxxyy = xyyx(xyxy)yxxyy
xyyx(yx)yxyxxyy = xyyx(xy)yxyxxyy
xyyxyx(yx)yxxyy = xyyxyx(xy)yxxyy
xyyx(yx)yyxxxyy = xyyx(xy)yyxxxyy
xyyxyyx(yx)xyyx = xyyxyyx(xy)xyyx
xyyxyyx(yx)yxxy = xyyxyyx(xy)yxxy
xyyxy(yx)yyxxxy = xyyxy(xy)yyxxxy
xyyxy(yx)yyxxyx = xyyxy(xy)yyxxyx
xyyyxx(yx)xyxyy = xyyyxx(xy)xyxyy
xyyyxx(yx)xyyxy = xyyyxx(xy)xyyxy
xyyyxx(yx)xyyyx = xyyyxx(xy)xyyyx
xyyyxx(yx)yxxyy = xyyyxx(xy)yxxyy
xyyyxxy(yx)xyyx = xyyyxxy(xy)xyyx
xyyyxxy(yx)yxxy = xyyyxxy(xy)yxxy
xyyyx(yxx)xyyyx = xyyyx(xxy)xyyyx
xyyyx(yx)xxyyyx = xyyyx(xy)xxyyyx
xyyyx(yx)xyxyyx = xyyyx(xy)xyxyyx
xyyyx(yxxy)xyyx = xyyyx(xyyx)xyyx
xyyyx(yx)xyyxxy = xyyyx(xy)xyyxxy
xyyyx(yxxy)yxxy = xyyyx(xyyx)yxxy
xyyyx(yx)xyyxyx = xyyyx(xy)xyyxyx
xyyyx(yx)xyyyxx = xyyyx(xy)xyyyxx
xyyyx(yx)yxxxyy = xyyyx(xy)yxxxyy
xyyyx(yx)yxxyxy = xyyyx(xy)yxxyxy
xyyyx(yxyx)xyyx = xyyyx(xyxy)xyyx
xyyyx(yx)yxxyyx = xyyyx(xy)yxxyyx
xyyyxyx(yx)xyyx = xyyyxyx(xy)xyyx
xyyyx(yxyx)yxxy = xyyyx(xyxy)yxxy
xyyyx(yx)yxyxxy = xyyyx(xy)yxyxxy
xyyyxyx(yx)yxxy = xyyyxyx(xy)yxxy
xyyyx(yx)yxyxyx = xyyyx(xy)yxyxyx
xyyyx(yx)yyxxxy = xyyyx(xy)yyxxxy
xyyyx(yx)yyxxyx = xyyyx(xy)yyxxyx
xyyyyxx(yx)xyxy = xyyyyxx(xy)xyxy
xyyyyxx(yx)xyyx = xyyyyxx(xy)xyyx
xyyyyxx(yx)yxxy = xyyyyxx(xy)yxxy
xyyyyx(yx)xyyxx = xyyyyx(xy)xyyxx
xyyyyx(yx)yxxxy = xyyyyx(xy)yxxxy
xyyyyx(yx)yxxyx = xyyyyx(xy)yxxyx
xyyyyx(yx)yxyxx = xyyyyx(xy)yxyxx
xyyyyyxx(yx)xyx = xyyyyyxx(xy)xyx
#  relations (7,6)
xxxyyx(yx)xyyxy = xxxyyx(xy)xyyxy
xxxyyx(yx)xyyyx = xxxyyx(xy)xyyyx
xxxyyx(yx)yxxyy = xxxyyx(xy)yxxyy
xxxyyyx(yx)xyyx = xxxyyyx(xy)xyyx
xxxyyyx(yx)yxxy = xxxyyyx(xy)yxxy
xxyxxxyy(yx)yxy = xxyxxxyy(xy)yxy
xxyxxy(yx)xyyxy = xxyxxy(xy)xyyxy
xxyxxy(yx)xyyyx = xxyxxy(xy)xyyyx
xxyxxy(yx)yxxyy = xxyxxy(xy)yxxyy
xxyx(yx)xxyyxyy = xxyx(xy)xxyyxyy
xxyx(yx)xxyyyxy = xxyx(xy)xxyyyxy
xxyx(yx)xxyyyyx = xxyx(xy)xxyyyyx
xxyxyyx(yx)xyyx = xxyxyyx(xy)xyyx
xxyxyyx(yx)yxxy = xxyxyyx(xy)yxxy
xxyxy(yx)yyxxxy = xxyxy(xy)yyxxxy
xxyyxxy(yx)xyyx = xxyyxxy(xy)xyyx
xxyyxxy(yx)yxxy = xxyyxxy(xy)yxxy
xxyyx(yx)xxyyyx = xxyyx(xy)xxyyyx
xxyyx(yx)xyxyyx = xxyyx(xy)xyxyyx
xxyyx(yxxy)xyyx = xxyyx(xyyx)xyyx
xxyyx(yx)xyyxxy = xxyyx(xy)xyyxxy
xxyyx(yxxy)yxxy = xxyyx(xyyx)yxxy
xxyyx(yx)xyyxyx = xxyyx(xy)xyyxyx
xxyyx(yx)xyyyxx = xxyyx(xy)xyyyxx
xxyyx(yx)yxxxyy = xxyyx(xy)yxxxyy
xxyyx(yx)yxxyxy = xxyyx(xy)yxxyxy
xxyyx(yxyx)xyyx = xxyyx(xyxy)xyyx
xxyyx(yx)yxxyyx = xxyyx(xy)yxxyyx
xxyyxyx(yx)xyyx = xxyyxyx(xy)xyyx
xxyyx(yxyx)yxxy = xxyyx(xyxy)yxxy
xxyyx(yx)yxyxxy = xxyyx(xy)yxyxxy
xxyyxyx(yx)yxxy = xxyyxyx(xy)yxxy
xxyyx(yx)yyxxxy = xxyyx(xy)yyxxxy
xxyyyxx(yx)xyxy = xxyyyxx(xy)xyxy
xxyyyxx(yx)xyyx = xxyyyxx(xy)xyyx
xxyyyxx(yx)yxxy = xxyyyxx(xy)yxxy
xxyyyx(yx)xyyxx = xxyyyx(xy)xyyxx
xxyyyx(yx)yxxxy = xxyyyx(xy)yxxxy
xxyyyx(yx)yxxyx = xxyyyx(xy)yxxyx
xxyyyyxx(yx)xyx = xxyyyyxx(xy)xyx
xyxxxxyy(yx)yxy = xyxxxxyy(xy)yxy
xyxxxy(yx)xyyxy = xyxxxy(xy)xyyxy
xyxxxy(yx)xyyyx = xyxxxy(xy)xyyyx
xyxxxy(yx)yxxyy = xyxxxy(xy)yxxyy
xyxxxyy(yx)xyyx = xyxxxyy(xy)xyyx
xyxxxyy(yx)yxxy = xyxxxyy(xy)yxxy
xyxxxyy(yx)yxyx = xyxxxyy(xy)yxyx
xyxxyxy(yx)xyyx = xyxxyxy(xy)xyyx
xyxxyxy(yx)yxxy = xyxxyxy(xy)yxxy
xyxxy(yx)xxyyyx = xyxxy(xy)xxyyyx
xyxxy(yx)xyxyyx = xyxxy(xy)xyxyyx
xyxxy(yxxy)xyyx = xyxxy(xyyx)xyyx
xyxxy(yx)xyyxxy = xyxxy(xy)xyyxxy
xyxxy(yxxy)yxxy = xyxxy(xyyx)yxxy
xyxxy(yx)xyyxyx = xyxxy(xy)xyyxyx
xyxxy(yx)xyyyxx = xyxxy(xy)xyyyxx
xyxxy(yx)yxxxyy = xyxxy(xy)yxxxyy
xyxxy(yx)yxxyxy = xyxxy(xy)yxxyxy
xyxxy(yxyx)xyyx = xyxxy(xyxy)xyyx
xyxxy(yx)yxxyyx = xyxxy(xy)yxxyyx
xyxxyyx(yx)xyyx = xyxxyyx(xy)xyyx
xyxxy(yxyx)yxxy = xyxxy(xyxy)yxxy
xyxxy(yx)yxyxxy = xyxxy(xy)yxyxxy
xyxxyyx(yx)yxxy = xyxxyyx(xy)yxxy
xyxxy(yx)yyxxxy = xyxxy(xy)yyxxxy
xyx(yx)xxxyyyyx = xyx(xy)xxxyyyyx
xyx(yx)xxyxyyyx = xyx(xy)xxyxyyyx
xyx(yx)xxyyxyyx = xyx(xy)xxyyxyyx
xyx(yx)xxyyyxxy = xyx(xy)xxyyyxxy
xyx(yx)xxyyyxyx = xyx(xy)xxyyyxyx
xyx(yx)xxyyyyxx = xyx(xy)xxyyyyxx
xyxyxxy(yx)xyyx = xyxyxxy(xy)xyyx
xyxyxxy(yx)yxxy = xyxyxxy(xy)yxxy
xyx(yx)yxxxxyyy = xyx(xy)yxxxxyyy
xyxyx(yx)xxyyyx = xyxyx(xy)xxyyyx
xyxyx(yx)yxxxyy = xyxyx(xy)yxxxyy
xyxyyx(yx)xyyxx = xyxyyx(xy)xyyxx
xyxyyx(yx)yxxxy = xyxyyx(xy)yxxxy
xyxyyx(yx)yxxyx = xyxyyx(xy)yxxyx
xyxy(yx)yyxxxxy = xyxy(xy)yyxxxxy
xyxy(yx)yyxxxyx = xyxy(xy)yyxxxyx
xyxyyyxx(yx)xyx = xyxyyyxx(xy)xyx
xyyxxxy(yx)xyyx = xyyxxxy(xy)xyyx
xyyxxxy(yx)yxxy = xyyxxxy(xy)yxxy
xyyxx(yx)xxyyxy = xyyxx(xy)xxyyxy
xyyxx(yx)xxyyyx = xyyxx(xy)xxyyyx
xyyxx(yx)xyxxyy = xyyxx(xy)xyxxyy
xyyxx(yx)yxxxyy = xyyxx(xy)yxxxyy
xyyxxy(yx)xyyxx = xyyxxy(xy)xyyxx
xyyxxy(yx)yxxxy = xyyxxy(xy)yxxxy
xyyxxy(yx)yxxyx = xyyxxy(xy)yxxyx
xyyx(yx)xxyyyxx = xyyx(xy)xxyyyxx
xyyx(yx)xyxyyxx = xyyx(xy)xyxyyxx
xyyx(yxxy)xyyxx = xyyx(xyyx)xyyxx
xyyx(yx)xyyxxxy = xyyx(xy)xyyxxxy
xyyx(yxxy)yxxxy = xyyx(xyyx)yxxxy
xyyx(yx)xyyxxyx = xyyx(xy)xyyxxyx
xyyx(yxxy)yxxyx = xyyx(xyyx)yxxyx
xyyx(yx)xyyxyxx = xyyx(xy)xyyxyxx
xyyx(yx)xyyyxxx = xyyx(xy)xyyyxxx
xyyx(yx)yxxxxyy = xyyx(xy)yxxxxyy
xyyx(yx)yxxxyxy = xyyx(xy)yxxxyxy
xyyx(yx)yxxxyyx = xyyx(xy)yxxxyyx
xyyx(yx)yxxyxxy = xyyx(xy)yxxyxxy
xyyx(yx)yxxyxyx = xyyx(xy)yxxyxyx
xyyx(yxyx)xyyxx = xyyx(xyxy)xyyxx
xyyx(yx)yxxyyxx = xyyx(xy)yxxyyxx
xyyxyx(yx)xyyxx = xyyxyx(xy)xyyxx
xyyx(yxyx)yxxxy = xyyx(xyxy)yxxxy
xyyx(yx)yxyxxxy = xyyx(xy)yxyxxxy
xyyxyx(yx)yxxxy = xyyxyx(xy)yxxxy
xyyx(yxyx)yxxyx = xyyx(xyxy)yxxyx
xyyx(yx)yxyxxyx = xyyx(xy)yxyxxyx
xyyxyx(yx)yxxyx = xyyxyx(xy)yxxyx
xyyx(yx)yyxxxxy = xyyx(xy)yyxxxxy
xyyx(yx)yyxxxyx = xyyx(xy)yyxxxyx
xyyxyyxx(yx)xyx = xyyxyyxx(xy)xyx
xyyyxx(yx)xxyyx = xyyyxx(xy)xxyyx
xyyyxx(yx)xyxxy = xyyyxx(xy)xyxxy
xyyyxx(yx)xyxyx = xyyyxx(xy)xyxyx
xyyyxx(yx)xyyxx = xyyyxx(xy)xyyxx
xyyyxx(yx)yxxxy = xyyyxx(xy)yxxxy
xyyyxx(yx)yxxyx = xyyyxx(xy)yxxyx
xyyyxyxx(yx)xyx = xyyyxyxx(xy)xyx
xyyyx(yx)xyyxxx = xyyyx(xy)xyyxxx
xyyyx(yx)yxxxxy = xyyyx(xy)yxxxxy
xyyyx(yx)yxxxyx = xyyyx(xy)yxxxyx
xyyyx(yx)yxxyxx = xyyyx(xy)yxxyxx
xyyyyxxx(yx)xyx = xyyyyxxx(xy)xyx
xyyyyxx(yx)xyxx = xyyyyxx(xy)xyxx
#  relations (8,5)
xxxxyyx(yx)xyyx = xxxxyyx(xy)xyyx
xxxxyyx(yx)yxxy = xxxxyyx(xy)yxxy
xxxyxxy(yx)xyyx = xxxyxxy(xy)xyyx
xxxyxxy(yx)yxxy = xxxyxxy(xy)yxxy
xxxyx(yx)xxyyyx = xxxyx(xy)xxyyyx
xxxyyx(yx)xyyxx = xxxyyx(xy)xyyxx
xxxyyx(yx)yxxxy = xxxyyx(xy)yxxxy
xxxyyx(yx)yxxyx = xxxyyx(xy)yxxyx
xxxyyyxx(yx)xyx = xxxyyyxx(xy)xyx
xxyxxxy(yx)xyyx = xxyxxxy(xy)xyyx
xxyxxxy(yx)yxxy = xxyxxxy(xy)yxxy
xxyxxy(yx)xyyxx = xxyxxy(xy)xyyxx
xxyxxy(yx)yxxxy = xxyxxy(xy)yxxxy
xxyxxy(yx)yxxyx = xxyxxy(xy)yxxyx
xxyx(yx)xxyyyxx = xxyx(xy)xxyyyxx
xxyx(yx)yxxxxyy = xxyx(xy)yxxxxyy
xxyxyx(yx)yxxxy = xxyxyx(xy)yxxxy
xxyyxx(yx)xxyyx = xxyyxx(xy)xxyyx
xxyyxx(yx)xyxxy = xxyyxx(xy)xyxxy
xxyyxx(yx)yxxxy = xxyyxx(xy)yxxxy
xxyyx(yx)xyyxxx = xxyyx(xy)xyyxxx
xxyyx(yx)yxxxxy = xxyyx(xy)yxxxxy
xxyyx(yx)yxxxyx = xxyyx(xy)yxxxyx
xxyyx(yx)yxxyxx = xxyyx(xy)yxxyxx
xxyyyxx(yx)xyxx = xxyyyxx(xy)xyxx
xyxxxxy(yx)xyxy = xyxxxxy(xy)xyxy
xyxxxxy(yx)xyyx = xyxxxxy(xy)xyyx
xyxxxxy(yx)yxxy = xyxxxxy(xy)yxxy
xyxxxy(yx)xxyyx = xyxxxy(xy)xxyyx
xyxxxy(yx)xyxyx = xyxxxy(xy)xyxyx
xyxxxy(yx)xyyxx = xyxxxy(xy)xyyxx
xyxxxy(yx)yxxxy = xyxxxy(xy)yxxxy
xyxxxy(yx)yxxyx = xyxxxy(xy)yxxyx
xyxx(yx)xxxyyxy = xyxx(xy)xxxyyxy
xyxx(yx)xxxyyyx = xyxx(xy)xxxyyyx
xyxxyx(yx)xxyyx = xyxxyx(xy)xxyyx
xyxxy(yx)xyyxxx = xyxxy(xy)xyyxxx
xyxxy(yx)yxxxxy = xyxxy(xy)yxxxxy
xyxxy(yx)yxxxyx = xyxxy(xy)yxxxyx
xyxxy(yx)yxxyxx = xyxxy(xy)yxxyxx
xyx(yx)xxyyyxxx = xyx(xy)xxyyyxxx
xyxyxx(yx)xxyyx = xyxyxx(xy)xxyyx
xyx(yx)yxxxxxyy = xyx(xy)yxxxxxyy
xyx(yx)yxxxxyxy = xyx(xy)yxxxxyxy
xyx(yx)yxxxxyyx = xyx(xy)yxxxxyyx
xyxyx(yx)yxxxxy = xyxyx(xy)yxxxxy
xyxyx(yx)yxxxyx = xyxyx(xy)yxxxyx
xyyxxxxy(yx)xyx = xyyxxxxy(xy)xyx
xyyxxx(yx)xxyxy = xyyxxx(xy)xxyxy
xyyxxx(yx)xxyyx = xyyxxx(xy)xxyyx
xyyxx(yxx)xxyyx = xyyxx(xxy)xxyyx
xyyxx(yx)xxxyyx = xyyxx(xy)xxxyyx
xyyxx(yx)xxyxyx = xyyxx(xy)xxyxyx
xyyxx(yx)xxyyxx = xyyxx(xy)xxyyxx
xyyxx(yx)xyxxxy = xyyxx(xy)xyxxxy
xyyxx(yx)xyxxyx = xyyxx(xy)xyxxyx
xyyxx(yx)yxxxxy = xyyxx(xy)yxxxxy
xyyxx(yx)yxxxyx = xyyxx(xy)yxxxyx
xyyx(yx)xyyxxxx = xyyx(xy)xyyxxxx
xyyx(yx)yxxxxxy = xyyx(xy)yxxxxxy
xyyx(yx)yxxxxyx = xyyx(xy)yxxxxyx
xyyx(yx)yxxxyxx = xyyx(xy)yxxxyxx
xyyx(yx)yxxyxxx = xyyx(xy)yxxyxxx
xyyyxxx(yx)xxyx = xyyyxxx(xy)xxyx
xyyyxx(yx)xyxxx = xyyyxx(xy)xyxxx
#  relations (9,4)
xxxyx(yx)yxxxxy = xxxyx(xy)yxxxxy
xxyxxxxy(yx)xyx = xxyxxxxy(xy)xyx
xxyxx(yx)xxxyyx = xxyxx(xy)xxxyyx
xxyx(yx)yxxxxxy = xxyx(xy)yxxxxxy
xxyx(yx)yxxxxyx = xxyx(xy)yxxxxyx
xxyyxxx(yx)xxyx = xxyyxxx(xy)xxyx
xyxxxxxy(yx)xyx = xyxxxxxy(xy)xyx
xyxxxxy(yx)xyxx = xyxxxxy(xy)xyxx
xyxx(yx)xxxyyxx = xyxx(xy)xxxyyxx
xyx(yx)yxxxxxxy = xyx(xy)yxxxxxxy
xyx(yx)yxxxxxyx = xyx(xy)yxxxxxyx
xyx(yx)yxxxxyxx = xyx(xy)yxxxxyxx
xyyxxx(yx)xxyxx = xyyxxx(xy)xxyxx
