# triangular similar diagonal relations for n = 8
#  relations (3,5)
xy(yx)xyyy = xy(xy)xyyy
xy(yx)yxyy = xy(xy)yxyy
xy(yx)yyxy = xy(xy)yyxy
xy(yx)yyyx = xy(xy)yyyx
xy(yyx)xyy = xy(xyy)xyy
xyy(yx)xyy = xyy(xy)xyy
xy(yyx)yxy = xy(xyy)yxy
xyy(yx)yxy = xyy(xy)yxy
xy(yyx)yyx = xy(xyy)yyx
xyy(yx)yyx = xyy(xy)yyx
xy(yyyx)xy = xy(xyyy)xy
xyy(yyx)xy = xyy(xyy)xy
xyyy(yx)xy = xyyy(xy)xy
xy(yyyx)yx = xy(xyyy)yx
xyy(yyx)yx = xyy(xyy)yx
xyyy(yx)yx = xyyy(xy)yx
#  relations (4,4)
xxy(yx)xyy = xxy(xy)xyy
xxy(yx)yxy = xxy(xy)yxy
xxy(yx)yyx = xxy(xy)yyx
xxy(yyx)xy = xxy(xyy)xy
xxyy(yx)xy = xxyy(xy)xy
xxy(yyx)yx = xxy(xyy)yx
xxyy(yx)yx = xxyy(xy)yx
xyx(yx)xyy = xyx(xy)xyy
xyx(yx)yxy = xyx(xy)yxy
xyx(yx)yyx = xyx(xy)yyx
xyx(yyx)xy = xyx(xyy)xy
xyxy(yx)xy = xyxy(xy)xy
xyx(yyx)yx = xyx(xyy)yx
xyxy(yx)yx = xyxy(xy)yx
xy(yxx)xyy = xy(xxy)xyy
xy(yx)xxyy = xy(xy)xxyy
xy(yxx)yxy = xy(xxy)yxy
xy(yx)xyxy = xy(xy)xyxy
xy(yxxy)xy = xy(xyyx)xy
xy(yxx)yyx = xy(xxy)yyx
xy(yx)xyyx = xy(xy)xyyx
xy(yxxy)yx = xy(xyyx)yx
xy(yxyx)xy = xy(xxyy)xy
xy(yxyx)xy = xy(xyxy)xy
xy(yx)yxxy = xy(xy)yxxy
xyyx(yx)xy = xyyx(xy)xy
xy(yxyx)yx = xy(xxyy)yx
xy(yxyx)yx = xy(xyxy)yx
xy(yx)yxyx = xy(xy)yxyx
xyyx(yx)yx = xyyx(xy)yx
xy(yx)yyxx = xy(xy)yyxx
xy(yyxx)xy = xy(xxyy)xy
xy(yyxx)xy = xy(xyxy)xy
xy(yyx)xxy = xy(xyy)xxy
xyy(yxx)xy = xyy(xxy)xy
xyy(yx)xxy = xyy(xy)xxy
xy(yyxx)yx = xy(xxyy)yx
xy(yyxx)yx = xy(xyxy)yx
xy(yyx)xyx = xy(xyy)xyx
xyy(yxx)yx = xyy(xxy)yx
xyy(yx)xyx = xyy(xy)xyx
xy(yyx)yxx = xy(xyy)yxx
xyy(yx)yxx = xyy(xy)yxx
#  relations (5,3)
xxxy(yx)xy = xxxy(xy)xy
xxxy(yx)yx = xxxy(xy)yx
xxyx(yx)xy = xxyx(xy)xy
xxyx(yx)yx = xxyx(xy)yx
xxy(yxx)xy = xxy(xxy)xy
xxy(yx)xxy = xxy(xy)xxy
xxy(yxx)yx = xxy(xxy)yx
xxy(yx)xyx = xxy(xy)xyx
xxy(yx)yxx = xxy(xy)yxx
xyxx(yx)xy = xyxx(xy)xy
xyxx(yx)yx = xyxx(xy)yx
xyx(yxx)xy = xyx(xxy)xy
xyx(yx)xxy = xyx(xy)xxy
xyx(yxx)yx = xyx(xxy)yx
xyx(yx)xyx = xyx(xy)xyx
xyx(yx)yxx = xyx(xy)yxx
xy(yxxx)xy = xy(xxxy)xy
xy(yxx)xxy = xy(xxy)xxy
xy(yx)xxxy = xy(xy)xxxy
xy(yxxx)yx = xy(xxxy)yx
xy(yxx)xyx = xy(xxy)xyx
xy(yx)xxyx = xy(xy)xxyx
xy(yxx)yxx = xy(xxy)yxx
xy(yx)xyxx = xy(xy)xyxx
xy(yx)yxxx = xy(xy)yxxx
