xxxxxyyyyx(yx)yxyy = xxxxxyyyyx(xy)yxyy
xxxxxyyyyyx(yx)yxy = xxxxxyyyyyx(xy)yxy
xxxxyxxyy(yx)yxyyy = xxxxyxxyy(xy)yxyyy
xxxxyxxyyy(yx)yyxy = xxxxyxxyyy(xy)yyxy
xxxxyxy(yx)xyyyyxy = xxxxyxy(xy)xyyyyxy
xxxxyxy(yx)xyyyyyx = xxxxyxy(xy)xyyyyyx
xxxxyxyy(yx)yyyxxy = xxxxyxyy(xy)yyyxxy
xxxxyxyyyyx(yx)yxy = xxxxyxyyyyx(xy)yxy
xxxxyyxxyy(yx)yxyy = xxxxyyxxyy(xy)yxyy
xxxxyyx(yx)xyyxyyy = xxxxyyx(xy)xyyxyyy
xxxxyyx(yx)xyyyxyy = xxxxyyx(xy)xyyyxyy
xxxxyyx(yx)xyyyyxy = xxxxyyx(xy)xyyyyxy
xxxxyyx(yx)xyyyyyx = xxxxyyx(xy)xyyyyyx
xxxxyyx(yx)yxxyyyy = xxxxyyx(xy)yxxyyyy
xxxxyyxy(yx)xyyyyx = xxxxyyxy(xy)xyyyyx
xxxxyyxy(yx)yyxxyy = xxxxyyxy(xy)yyxxyy
xxxxyyyx(yx)xyyxyy = xxxxyyyx(xy)xyyxyy
xxxxyyyx(yx)xyyyxy = xxxxyyyx(xy)xyyyxy
xxxxyyyx(yx)xyyyyx = xxxxyyyx(xy)xyyyyx
xxxxyyyx(yx)yxxyyy = xxxxyyyx(xy)yxxyyy
xxxxyyyx(yx)yxyxyy = xxxxyyyx(xy)yxyxyy
xxxxyyyx(yx)yyxxyy = xxxxyyyx(xy)yyxxyy
xxxxyyyxy(yx)yyxxy = xxxxyyyxy(xy)yyxxy
xxxxyyyyx(yx)xyyxy = xxxxyyyyx(xy)xyyxy
xxxxyyyyx(yx)xyyyx = xxxxyyyyx(xy)xyyyx
xxxxyyyyx(yx)yxxyy = xxxxyyyyx(xy)yxxyy
xxxxyyyyx(yx)yxyxy = xxxxyyyyx(xy)yxyxy
xxxxyyyyx(yx)yxyyx = xxxxyyyyx(xy)yxyyx
xxxxyyyyx(yx)yyxxy = xxxxyyyyx(xy)yyxxy
xxxxyyyyyx(yx)xyyx = xxxxyyyyyx(xy)xyyx
xxxxyyyyyx(yx)yxxy = xxxxyyyyyx(xy)yxxy
xxxxyyyyyx(yx)yxyx = xxxxyyyyyx(xy)yxyx
xxxyxxxyy(yx)yxyyy = xxxyxxxyy(xy)yxyyy
xxxyxxxyyy(yx)yxyy = xxxyxxxyyy(xy)yxyy
xxxyxxxyyy(yx)yyxy = xxxyxxxyyy(xy)yyxy
xxxyxxyxyy(yx)yxyy = xxxyxxyxyy(xy)yxyy
xxxyxxy(yx)xyyxyyy = xxxyxxy(xy)xyyxyyy
xxxyxxy(yx)xyyyxyy = xxxyxxy(xy)xyyyxyy
xxxyxxy(yx)xyyyyxy = xxxyxxy(xy)xyyyyxy
xxxyxxy(yx)xyyyyyx = xxxyxxy(xy)xyyyyyx
xxxyxxy(yx)yxxyyyy = xxxyxxy(xy)yxxyyyy
xxxyxxyy(yx)xyyyxy = xxxyxxyy(xy)xyyyxy
xxxyxxyy(yx)xyyyyx = xxxyxxyy(xy)xyyyyx
xxxyxxyy(yx)yxyyxy = xxxyxxyy(xy)yxyyxy
xxxyxxyy(yx)yxyyyx = xxxyxxyy(xy)yxyyyx
xxxyxxyy(yx)yyxxyy = xxxyxxyy(xy)yyxxyy
xxxyxxyy(yx)yyxyxy = xxxyxxyy(xy)yyxyxy
xxxyxxyy(yx)yyyxxy = xxxyxxyy(xy)yyyxxy
xxxyxxyyyyx(yx)yxy = xxxyxxyyyyx(xy)yxy
xxxyxxyy(yyx)yyxxy = xxxyxxyy(xyy)yyxxy
xxxyxxyyy(yx)yyxxy = xxxyxxyyy(xy)yyxxy
xxxyxxyyy(yx)yyxyx = xxxyxxyyy(xy)yyxyx
xxxyx(yx)xxyyxyyyy = xxxyx(xy)xxyyxyyyy
xxxyx(yx)xxyyyxyyy = xxxyx(xy)xxyyyxyyy
xxxyx(yx)xxyyyyxyy = xxxyx(xy)xxyyyyxyy
xxxyx(yx)xxyyyyyxy = xxxyx(xy)xxyyyyyxy
xxxyx(yx)xxyyyyyyx = xxxyx(xy)xxyyyyyyx
xxxyxyxxyy(yx)yxyy = xxxyxyxxyy(xy)yxyy
xxxyxyxy(yx)xyyyxy = xxxyxyxy(xy)xyyyxy
xxxyxyxy(yx)xyyyyx = xxxyxyxy(xy)xyyyyx
xxxyxyxyy(yx)yyxxy = xxxyxyxyy(xy)yyxxy
xxxyxy(yx)xyyyyxxy = xxxyxy(xy)xyyyyxxy
xxxyxy(yx)xyyyyxyx = xxxyxy(xy)xyyyyxyx
xxxyxy(yx)xyyyyyxx = xxxyxy(xy)xyyyyyxx
xxxyxyyx(yx)xyyxyy = xxxyxyyx(xy)xyyxyy
xxxyxyyx(yx)xyyyxy = xxxyxyyx(xy)xyyyxy
xxxyxyyx(yx)xyyyyx = xxxyxyyx(xy)xyyyyx
xxxyxyyx(yx)yxxyyy = xxxyxyyx(xy)yxxyyy
xxxyxy(yx)yyxxxyyy = xxxyxy(xy)yyxxxyyy
xxxyxyyxy(yx)yyxxy = xxxyxyyxy(xy)yyxxy
xxxyxyyyx(yx)xyyxy = xxxyxyyyx(xy)xyyxy
xxxyxyyyx(yx)xyyyx = xxxyxyyyx(xy)xyyyx
xxxyxyyyx(yx)yxxyy = xxxyxyyyx(xy)yxxyy
xxxyxyyyx(yx)yxyxy = xxxyxyyyx(xy)yxyxy
xxxyxyyyx(yx)yyxxy = xxxyxyyyx(xy)yyxxy
xxxyxyy(yx)yyyxxxy = xxxyxyy(xy)yyyxxxy
xxxyxyy(yx)yyyxxyx = xxxyxyy(xy)yyyxxyx
xxxyxyyyyx(yx)xyyx = xxxyxyyyyx(xy)xyyx
xxxyxyyyyx(yx)yxxy = xxxyxyyyyx(xy)yxxy
xxxyxyyyyx(yx)yxyx = xxxyxyyyyx(xy)yxyx
xxxyyxxxyy(yx)yxyy = xxxyyxxxyy(xy)yxyy
xxxyyxxy(yx)xyyxyy = xxxyyxxy(xy)xyyxyy
xxxyyxxy(yx)xyyyxy = xxxyyxxy(xy)xyyyxy
xxxyyxxy(yx)xyyyyx = xxxyyxxy(xy)xyyyyx
xxxyyxxy(yx)yxxyyy = xxxyyxxy(xy)yxxyyy
xxxyyxxyy(yx)xyyyx = xxxyyxxyy(xy)xyyyx
xxxyyxxyy(yx)yxyyx = xxxyyxxyy(xy)yxyyx
xxxyyxxyy(yx)yyxxy = xxxyyxxyy(xy)yyxxy
xxxyyx(yx)xxyyyxyy = xxxyyx(xy)xxyyyxyy
xxxyyx(yx)xxyyyyxy = xxxyyx(xy)xxyyyyxy
xxxyyx(yx)xxyyyyyx = xxxyyx(xy)xxyyyyyx
xxxyyx(yx)xyxyyxyy = xxxyyx(xy)xyxyyxyy
xxxyyx(yxxy)xyyxyy = xxxyyx(xyyx)xyyxyy
xxxyyx(yx)xyxyyyxy = xxxyyx(xy)xyxyyyxy
xxxyyx(yxxy)xyyyxy = xxxyyx(xyyx)xyyyxy
xxxyyx(yx)xyxyyyyx = xxxyyx(xy)xyxyyyyx
xxxyyx(yxxy)xyyyyx = xxxyyx(xyyx)xyyyyx
xxxyyx(yx)xyyxxyyy = xxxyyx(xy)xyyxxyyy
xxxyyx(yxxy)yxxyyy = xxxyyx(xyyx)yxxyyy
xxxyyx(yx)xyyxyxyy = xxxyyx(xy)xyyxyxyy
xxxyyx(yx)xyyxyyxy = xxxyyx(xy)xyyxyyxy
xxxyyx(yx)xyyxyyyx = xxxyyx(xy)xyyxyyyx
xxxyyx(yx)xyyyxxyy = xxxyyx(xy)xyyyxxyy
xxxyyx(yx)xyyyxyxy = xxxyyx(xy)xyyyxyxy
xxxyyx(yx)xyyyxyyx = xxxyyx(xy)xyyyxyyx
xxxyyx(yx)xyyyyxxy = xxxyyx(xy)xyyyyxxy
xxxyyx(yx)xyyyyxyx = xxxyyx(xy)xyyyyxyx
xxxyyx(yx)xyyyyyxx = xxxyyx(xy)xyyyyyxx
xxxyyx(yx)yxxxyyyy = xxxyyx(xy)yxxxyyyy
xxxyyx(yx)yxxyxyyy = xxxyyx(xy)yxxyxyyy
xxxyyx(yxyx)xyyxyy = xxxyyx(xyxy)xyyxyy
xxxyyx(yx)yxxyyxyy = xxxyyx(xy)yxxyyxyy
xxxyyxyx(yx)xyyxyy = xxxyyxyx(xy)xyyxyy
xxxyyx(yxyx)xyyyxy = xxxyyx(xyxy)xyyyxy
xxxyyx(yx)yxxyyyxy = xxxyyx(xy)yxxyyyxy
xxxyyxyx(yx)xyyyxy = xxxyyxyx(xy)xyyyxy
xxxyyx(yxyx)xyyyyx = xxxyyx(xyxy)xyyyyx
xxxyyx(yx)yxxyyyyx = xxxyyx(xy)yxxyyyyx
xxxyyxyx(yx)xyyyyx = xxxyyxyx(xy)xyyyyx
xxxyyx(yxyx)yxxyyy = xxxyyx(xyxy)yxxyyy
xxxyyx(yx)yxyxxyyy = xxxyyx(xy)yxyxxyyy
xxxyyxyx(yx)yxxyyy = xxxyyxyx(xy)yxxyyy
xxxyyx(yx)yyxxxyyy = xxxyyx(xy)yyxxxyyy
xxxyyxyxy(yx)xyyyx = xxxyyxyxy(xy)xyyyx
xxxyyxy(yx)xyyyyxx = xxxyyxy(xy)xyyyyxx
xxxyyxyyx(yx)xyyxy = xxxyyxyyx(xy)xyyxy
xxxyyxyyx(yx)xyyyx = xxxyyxyyx(xy)xyyyx
xxxyyxyyx(yx)yxxyy = xxxyyxyyx(xy)yxxyy
xxxyyxy(yx)yyxxxyy = xxxyyxy(xy)yyxxxyy
xxxyyxy(yx)yyxxyxy = xxxyyxy(xy)yyxxyxy
xxxyyxy(yx)yyxxyyx = xxxyyxy(xy)yyxxyyx
xxxyyxy(yx)yyxyxxy = xxxyyxy(xy)yyxyxxy
xxxyyxy(yx)yyyxxxy = xxxyyxy(xy)yyyxxxy
xxxyyxyyyx(yx)xyyx = xxxyyxyyyx(xy)xyyx
xxxyyxyyyx(yx)yxxy = xxxyyxyyyx(xy)yxxy
xxxyyyxxxyy(yx)yxy = xxxyyyxxxyy(xy)yxy
xxxyyyxx(yx)xyxyyy = xxxyyyxx(xy)xyxyyy
xxxyyyxx(yx)xyyxyy = xxxyyyxx(xy)xyyxyy
xxxyyyxx(yx)xyyyxy = xxxyyyxx(xy)xyyyxy
xxxyyyxx(yx)xyyyyx = xxxyyyxx(xy)xyyyyx
xxxyyyxx(yx)yxxyyy = xxxyyyxx(xy)yxxyyy
xxxyyyxxy(yx)xyyxy = xxxyyyxxy(xy)xyyxy
xxxyyyxxy(yx)xyyyx = xxxyyyxxy(xy)xyyyx
xxxyyyxxy(yx)yxxyy = xxxyyyxxy(xy)yxxyy
xxxyyyx(yxx)xyyyxy = xxxyyyx(xxy)xyyyxy
xxxyyyx(yx)xxyyyxy = xxxyyyx(xy)xxyyyxy
xxxyyyx(yxx)xyyyyx = xxxyyyx(xxy)xyyyyx
xxxyyyx(yx)xxyyyyx = xxxyyyx(xy)xxyyyyx
xxxyyyx(yx)xyxyyxy = xxxyyyx(xy)xyxyyxy
xxxyyyx(yxxy)xyyxy = xxxyyyx(xyyx)xyyxy
xxxyyyx(yx)xyxyyyx = xxxyyyx(xy)xyxyyyx
xxxyyyx(yxxy)xyyyx = xxxyyyx(xyyx)xyyyx
xxxyyyx(yx)xyyxxyy = xxxyyyx(xy)xyyxxyy
xxxyyyx(yxxy)yxxyy = xxxyyyx(xyyx)yxxyy
xxxyyyx(yx)xyyxyxy = xxxyyyx(xy)xyyxyxy
xxxyyyx(yx)xyyxyyx = xxxyyyx(xy)xyyxyyx
xxxyyyx(yx)xyyyxxy = xxxyyyx(xy)xyyyxxy
xxxyyyx(yx)xyyyxyx = xxxyyyx(xy)xyyyxyx
xxxyyyx(yx)xyyyyxx = xxxyyyx(xy)xyyyyxx
xxxyyyx(yx)yxxxyyy = xxxyyyx(xy)yxxxyyy
xxxyyyx(yx)yxxyxyy = xxxyyyx(xy)yxxyxyy
xxxyyyx(yxyx)xyyxy = xxxyyyx(xyxy)xyyxy
xxxyyyx(yx)yxxyyxy = xxxyyyx(xy)yxxyyxy
xxxyyyxyx(yx)xyyxy = xxxyyyxyx(xy)xyyxy
xxxyyyx(yxyx)xyyyx = xxxyyyx(xyxy)xyyyx
xxxyyyx(yx)yxxyyyx = xxxyyyx(xy)yxxyyyx
xxxyyyxyx(yx)xyyyx = xxxyyyxyx(xy)xyyyx
xxxyyyx(yxyx)yxxyy = xxxyyyx(xyxy)yxxyy
xxxyyyx(yx)yxyxxyy = xxxyyyx(xy)yxyxxyy
xxxyyyxyx(yx)yxxyy = xxxyyyxyx(xy)yxxyy
xxxyyyx(yx)yxyxyxy = xxxyyyx(xy)yxyxyxy
xxxyyyx(yx)yxyxyyx = xxxyyyx(xy)yxyxyyx
xxxyyyx(yx)yxyyxxy = xxxyyyx(xy)yxyyxxy
xxxyyyx(yx)yyxxxyy = xxxyyyx(xy)yyxxxyy
xxxyyyx(yx)yyxxyxy = xxxyyyx(xy)yyxxyxy
xxxyyyx(yx)yyxxyyx = xxxyyyx(xy)yyxxyyx
xxxyyyx(yx)yyxyxxy = xxxyyyx(xy)yyxyxxy
xxxyyyx(yx)yyyxxxy = xxxyyyx(xy)yyyxxxy
xxxyyyxyyx(yx)xyyx = xxxyyyxyyx(xy)xyyx
xxxyyyxyyx(yx)yxxy = xxxyyyxyyx(xy)yxxy
xxxyyyx(yyx)yyxxxy = xxxyyyx(xyy)yyxxxy
xxxyyyxy(yx)yyxxxy = xxxyyyxy(xy)yyxxxy
xxxyyyxy(yx)yyxxyx = xxxyyyxy(xy)yyxxyx
xxxyyyyxx(yx)xyxyy = xxxyyyyxx(xy)xyxyy
xxxyyyyxx(yx)xyyxy = xxxyyyyxx(xy)xyyxy
xxxyyyyxx(yx)xyyyx = xxxyyyyxx(xy)xyyyx
xxxyyyyxx(yx)yxxyy = xxxyyyyxx(xy)yxxyy
xxxyyyyxxy(yx)xyyx = xxxyyyyxxy(xy)xyyx
xxxyyyyxxy(yx)yxxy = xxxyyyyxxy(xy)yxxy
xxxyyyyx(yxx)xyyyx = xxxyyyyx(xxy)xyyyx
xxxyyyyx(yx)xxyyyx = xxxyyyyx(xy)xxyyyx
xxxyyyyx(yx)xyxyyx = xxxyyyyx(xy)xyxyyx
xxxyyyyx(yxxy)xyyx = xxxyyyyx(xyyx)xyyx
xxxyyyyx(yx)xyyxxy = xxxyyyyx(xy)xyyxxy
xxxyyyyx(yxxy)yxxy = xxxyyyyx(xyyx)yxxy
xxxyyyyx(yx)xyyxyx = xxxyyyyx(xy)xyyxyx
xxxyyyyx(yx)xyyyxx = xxxyyyyx(xy)xyyyxx
xxxyyyyx(yx)yxxxyy = xxxyyyyx(xy)yxxxyy
xxxyyyyx(yx)yxxyxy = xxxyyyyx(xy)yxxyxy
xxxyyyyx(yxyx)xyyx = xxxyyyyx(xyxy)xyyx
xxxyyyyx(yx)yxxyyx = xxxyyyyx(xy)yxxyyx
xxxyyyyxyx(yx)xyyx = xxxyyyyxyx(xy)xyyx
xxxyyyyx(yxyx)yxxy = xxxyyyyx(xyxy)yxxy
xxxyyyyx(yx)yxyxxy = xxxyyyyx(xy)yxyxxy
xxxyyyyxyx(yx)yxxy = xxxyyyyxyx(xy)yxxy
xxxyyyyx(yx)yxyxyx = xxxyyyyx(xy)yxyxyx
xxxyyyyx(yx)yxyyxx = xxxyyyyx(xy)yxyyxx
xxxyyyyx(yx)yyxxxy = xxxyyyyx(xy)yyxxxy
xxxyyyyx(yx)yyxxyx = xxxyyyyx(xy)yyxxyx
xxxyyyyyxx(yx)xyxy = xxxyyyyyxx(xy)xyxy
xxxyyyyyxx(yx)xyyx = xxxyyyyyxx(xy)xyyx
xxxyyyyyxx(yx)yxxy = xxxyyyyyxx(xy)yxxy
xxxyyyyyx(yx)xyyxx = xxxyyyyyx(xy)xyyxx
xxxyyyyyx(yx)yxxxy = xxxyyyyyx(xy)yxxxy
xxxyyyyyx(yx)yxxyx = xxxyyyyyx(xy)yxxyx
xxxyyyyyx(yx)yxyxx = xxxyyyyyx(xy)yxyxx
xxxyyyyyyxx(yx)xyx = xxxyyyyyyxx(xy)xyx
xxyxxxxyy(yx)yxyyy = xxyxxxxyy(xy)yxyyy
xxyxxxxyyy(yx)yxyy = xxyxxxxyyy(xy)yxyy
xxyxxxxyyy(yx)yyxy = xxyxxxxyyy(xy)yyxy
xxyxxxyxyy(yx)yxyy = xxyxxxyxyy(xy)yxyy
xxyxxxy(yx)xyyxyyy = xxyxxxy(xy)xyyxyyy
xxyxxxy(yx)xyyyxyy = xxyxxxy(xy)xyyyxyy
xxyxxxy(yx)xyyyyxy = xxyxxxy(xy)xyyyyxy
xxyxxxy(yx)xyyyyyx = xxyxxxy(xy)xyyyyyx
xxyxxxy(yx)yxxyyyy = xxyxxxy(xy)yxxyyyy
xxyxxxyy(yx)xyyxyy = xxyxxxyy(xy)xyyxyy
xxyxxxyy(yx)xyyyxy = xxyxxxyy(xy)xyyyxy
xxyxxxyy(yx)xyyyyx = xxyxxxyy(xy)xyyyyx
xxyxxxyy(yx)yxxyyy = xxyxxxyy(xy)yxxyyy
xxyxxxyy(yx)yxyxyy = xxyxxxyy(xy)yxyxyy
xxyxxxyy(yx)yxyyxy = xxyxxxyy(xy)yxyyxy
xxyxxxyy(yx)yxyyyx = xxyxxxyy(xy)yxyyyx
xxyxxxyy(yx)yyxxyy = xxyxxxyy(xy)yyxxyy
xxyxxxyy(yx)yyxyxy = xxyxxxyy(xy)yyxyxy
xxyxxxyy(yx)yyyxxy = xxyxxxyy(xy)yyyxxy
xxyxxxyy(yyx)xyyyx = xxyxxxyy(xyy)xyyyx
xxyxxxyyy(yx)xyyyx = xxyxxxyyy(xy)xyyyx
xxyxxxyyyyx(yx)yxy = xxyxxxyyyyx(xy)yxy
xxyxxxyyy(yx)yxyyx = xxyxxxyyy(xy)yxyyx
xxyxxxyy(yyx)yyxxy = xxyxxxyy(xyy)yyxxy
xxyxxxyyy(yx)yyxxy = xxyxxxyyy(xy)yyxxy
xxyxxxyyy(yx)yyxyx = xxyxxxyyy(xy)yyxyx
xxyxxyxxyy(yx)yxyy = xxyxxyxxyy(xy)yxyy
xxyxxyxy(yx)xyyxyy = xxyxxyxy(xy)xyyxyy
xxyxxyxy(yx)xyyyxy = xxyxxyxy(xy)xyyyxy
xxyxxyxy(yx)xyyyyx = xxyxxyxy(xy)xyyyyx
xxyxxyxy(yx)yxxyyy = xxyxxyxy(xy)yxxyyy
xxyxxyxyy(yx)xyyyx = xxyxxyxyy(xy)xyyyx
xxyxxyxyy(yx)yxyyx = xxyxxyxyy(xy)yxyyx
xxyxxyxyy(yx)yyxxy = xxyxxyxyy(xy)yyxxy
xxyxxy(yx)xxyyyxyy = xxyxxy(xy)xxyyyxyy
xxyxxy(yx)xxyyyyxy = xxyxxy(xy)xxyyyyxy
xxyxxy(yx)xxyyyyyx = xxyxxy(xy)xxyyyyyx
xxyxxy(yx)xyxyyxyy = xxyxxy(xy)xyxyyxyy
xxyxxy(yxxy)xyyxyy = xxyxxy(xyyx)xyyxyy
xxyxxy(yx)xyxyyyxy = xxyxxy(xy)xyxyyyxy
xxyxxy(yxxy)xyyyxy = xxyxxy(xyyx)xyyyxy
xxyxxy(yx)xyxyyyyx = xxyxxy(xy)xyxyyyyx
xxyxxy(yxxy)xyyyyx = xxyxxy(xyyx)xyyyyx
xxyxxy(yx)xyyxxyyy = xxyxxy(xy)xyyxxyyy
xxyxxy(yxxy)yxxyyy = xxyxxy(xyyx)yxxyyy
xxyxxy(yx)xyyxyxyy = xxyxxy(xy)xyyxyxyy
xxyxxy(yx)xyyxyyxy = xxyxxy(xy)xyyxyyxy
xxyxxy(yx)xyyxyyyx = xxyxxy(xy)xyyxyyyx
xxyxxy(yx)xyyyxxyy = xxyxxy(xy)xyyyxxyy
xxyxxy(yx)xyyyxyxy = xxyxxy(xy)xyyyxyxy
xxyxxy(yx)xyyyxyyx = xxyxxy(xy)xyyyxyyx
xxyxxy(yx)xyyyyxxy = xxyxxy(xy)xyyyyxxy
xxyxxy(yx)xyyyyxyx = xxyxxy(xy)xyyyyxyx
xxyxxy(yx)xyyyyyxx = xxyxxy(xy)xyyyyyxx
xxyxxy(yx)yxxxyyyy = xxyxxy(xy)yxxxyyyy
xxyxxy(yx)yxxyxyyy = xxyxxy(xy)yxxyxyyy
xxyxxy(yxyx)xyyxyy = xxyxxy(xyxy)xyyxyy
xxyxxy(yx)yxxyyxyy = xxyxxy(xy)yxxyyxyy
xxyxxyyx(yx)xyyxyy = xxyxxyyx(xy)xyyxyy
xxyxxy(yxyx)xyyyxy = xxyxxy(xyxy)xyyyxy
xxyxxy(yx)yxxyyyxy = xxyxxy(xy)yxxyyyxy
xxyxxyyx(yx)xyyyxy = xxyxxyyx(xy)xyyyxy
xxyxxy(yxyx)xyyyyx = xxyxxy(xyxy)xyyyyx
xxyxxy(yx)yxxyyyyx = xxyxxy(xy)yxxyyyyx
xxyxxyyx(yx)xyyyyx = xxyxxyyx(xy)xyyyyx
xxyxxy(yxyx)yxxyyy = xxyxxy(xyxy)yxxyyy
xxyxxy(yx)yxyxxyyy = xxyxxy(xy)yxyxxyyy
xxyxxyyx(yx)yxxyyy = xxyxxyyx(xy)yxxyyy
xxyxxy(yx)yyxxxyyy = xxyxxy(xy)yyxxxyyy
xxyxxyyxy(yx)xyyyx = xxyxxyyxy(xy)xyyyx
xxyxxyyxy(yx)yyxxy = xxyxxyyxy(xy)yyxxy
xxyxxyy(yx)xyyyxxy = xxyxxyy(xy)xyyyxxy
xxyxxyy(yxxy)yyxxy = xxyxxyy(xyyx)yyxxy
xxyxxyy(yx)xyyyxyx = xxyxxyy(xy)xyyyxyx
xxyxxyy(yx)xyyyyxx = xxyxxyy(xy)xyyyyxx
xxyxxyyyx(yx)xyyxy = xxyxxyyyx(xy)xyyxy
xxyxxyyyx(yx)xyyyx = xxyxxyyyx(xy)xyyyx
xxyxxyyyx(yx)yxxyy = xxyxxyyyx(xy)yxxyy
xxyxxyyyx(yx)yxyxy = xxyxxyyyx(xy)yxyxy
xxyxxyy(yxyx)yyxxy = xxyxxyy(xyxy)yyxxy
xxyxxyy(yx)yxyyxxy = xxyxxyy(xy)yxyyxxy
xxyxxyyyx(yx)yyxxy = xxyxxyyyx(xy)yyxxy
xxyxxyy(yx)yxyyxyx = xxyxxyy(xy)yxyyxyx
xxyxxyy(yx)yxyyyxx = xxyxxyy(xy)yxyyyxx
xxyxxyy(yx)yyxxxyy = xxyxxyy(xy)yyxxxyy
xxyxxyy(yx)yyxxyxy = xxyxxyy(xy)yyxxyxy
xxyxxyy(yx)yyxxyyx = xxyxxyy(xy)yyxxyyx
xxyxxyy(yx)yyxyxxy = xxyxxyy(xy)yyxyxxy
xxyxxyy(yx)yyxyxyx = xxyxxyy(xy)yyxyxyx
xxyxxyy(yx)yyyxxxy = xxyxxyy(xy)yyyxxxy
xxyxxyy(yx)yyyxxyx = xxyxxyy(xy)yyyxxyx
xxyxxyyyyx(yx)xyyx = xxyxxyyyyx(xy)xyyx
xxyxxyyyyx(yx)yxxy = xxyxxyyyyx(xy)yxxy
xxyxxyyyyx(yx)yxyx = xxyxxyyyyx(xy)yxyx
xxyxxyy(yyx)yyxxxy = xxyxxyy(xyy)yyxxxy
xxyxxyyy(yx)yyxxxy = xxyxxyyy(xy)yyxxxy
xxyxxyy(yyx)yyxxyx = xxyxxyy(xyy)yyxxyx
xxyxxyyy(yx)yyxxyx = xxyxxyyy(xy)yyxxyx
xxyxxyyy(yx)yyxyxx = xxyxxyyy(xy)yyxyxx
xxyx(yx)xxxyyyxyyy = xxyx(xy)xxxyyyxyyy
xxyx(yx)xxxyyyyxyy = xxyx(xy)xxxyyyyxyy
xxyx(yx)xxxyyyyyxy = xxyx(xy)xxxyyyyyxy
xxyx(yx)xxxyyyyyyx = xxyx(xy)xxxyyyyyyx
xxyx(yx)xxyxyyxyyy = xxyx(xy)xxyxyyxyyy
xxyx(yx)xxyxyyyxyy = xxyx(xy)xxyxyyyxyy
xxyx(yx)xxyxyyyyxy = xxyx(xy)xxyxyyyyxy
xxyx(yx)xxyxyyyyyx = xxyx(xy)xxyxyyyyyx
xxyx(yx)xxyyxxyyyy = xxyx(xy)xxyyxxyyyy
xxyx(yx)xxyyxyxyyy = xxyx(xy)xxyyxyxyyy
xxyx(yx)xxyyxyyxyy = xxyx(xy)xxyyxyyxyy
xxyx(yxxxyyxy)yxyy = xxyx(xyxxyyyx)yxyy
xxyx(yx)xxyyxyyyxy = xxyx(xy)xxyyxyyyxy
xxyx(yx)xxyyxyyyyx = xxyx(xy)xxyyxyyyyx
xxyx(yx)xxyyyxxyyy = xxyx(xy)xxyyyxxyyy
xxyx(yxxxyyyx)yxyy = xxyx(xyxxyyxy)yxyy
xxyx(yx)xxyyyxyxyy = xxyx(xy)xxyyyxyxyy
xxyxyxxxyy(yx)yxyy = xxyxyxxxyy(xy)yxyy
xxyx(yx)xxyyyxyyxy = xxyx(xy)xxyyyxyyxy
xxyx(yx)xxyyyxyyyx = xxyx(xy)xxyyyxyyyx
xxyx(yx)xxyyyyxxyy = xxyx(xy)xxyyyyxxyy
xxyx(yx)xxyyyyxyxy = xxyx(xy)xxyyyyxyxy
xxyx(yx)xxyyyyxyyx = xxyx(xy)xxyyyyxyyx
xxyx(yx)xxyyyyyxxy = xxyx(xy)xxyyyyyxxy
xxyx(yx)xxyyyyyxyx = xxyx(xy)xxyyyyyxyx
xxyx(yx)xxyyyyyyxx = xxyx(xy)xxyyyyyyxx
xxyxyxxy(yx)xyyxyy = xxyxyxxy(xy)xyyxyy
xxyxyxxy(yx)xyyyxy = xxyxyxxy(xy)xyyyxy
xxyxyxxy(yx)xyyyyx = xxyxyxxy(xy)xyyyyx
xxyxyxxy(yx)yxxyyy = xxyxyxxy(xy)yxxyyy
xxyxyxxyy(yx)xyyyx = xxyxyxxyy(xy)xyyyx
xxyxyxxyy(yx)yxyyx = xxyxyxxyy(xy)yxyyx
xxyxyxxyy(yx)yyxxy = xxyxyxxyy(xy)yyxxy
xxyx(yx)yxxxxyyyyy = xxyx(xy)yxxxxyyyyy
xxyxyx(yx)xxyyyxyy = xxyxyx(xy)xxyyyxyy
xxyxyx(yx)xxyyyyxy = xxyxyx(xy)xxyyyyxy
xxyxyx(yx)xxyyyyyx = xxyxyx(xy)xxyyyyyx
xxyxyx(yx)yxxxyyyy = xxyxyx(xy)yxxxyyyy
xxyxyxyxy(yx)xyyyx = xxyxyxyxy(xy)xyyyx
xxyxyxy(yx)xyyyxxy = xxyxyxy(xy)xyyyxxy
xxyxyxy(yx)xyyyxyx = xxyxyxy(xy)xyyyxyx
xxyxyxy(yx)xyyyyxx = xxyxyxy(xy)xyyyyxx
xxyxyxyyx(yx)xyyxy = xxyxyxyyx(xy)xyyxy
xxyxyxyyx(yx)xyyyx = xxyxyxyyx(xy)xyyyx
xxyxyxyyx(yx)yxxyy = xxyxyxyyx(xy)yxxyy
xxyxyxy(yx)yyxxxyy = xxyxyxy(xy)yyxxxyy
xxyxyxyyyx(yx)xyyx = xxyxyxyyyx(xy)xyyx
xxyxyxyyyx(yx)yxxy = xxyxyxyyyx(xy)yxxy
xxyxyxyy(yx)yyxxxy = xxyxyxyy(xy)yyxxxy
xxyxyxyy(yx)yyxxyx = xxyxyxyy(xy)yyxxyx
xxyxyyxxxyy(yx)yxy = xxyxyyxxxyy(xy)yxy
xxyxyyxxy(yx)xyyxy = xxyxyyxxy(xy)xyyxy
xxyxyyxxy(yx)xyyyx = xxyxyyxxy(xy)xyyyx
xxyxyyxxy(yx)yxxyy = xxyxyyxxy(xy)yxxyy
xxyxy(yx)xyyyyxxxy = xxyxy(xy)xyyyyxxxy
xxyxy(yx)xyyyyxxyx = xxyxy(xy)xyyyyxxyx
xxyxy(yx)xyyyyxyxx = xxyxy(xy)xyyyyxyxx
xxyxy(yx)xyyyyyxxx = xxyxy(xy)xyyyyyxxx
xxyxyyx(yx)xxyyyxy = xxyxyyx(xy)xxyyyxy
xxyxyyx(yx)xxyyyyx = xxyxyyx(xy)xxyyyyx
xxyxyyx(yx)xyxyyxy = xxyxyyx(xy)xyxyyxy
xxyxyyx(yxxy)xyyxy = xxyxyyx(xyyx)xyyxy
xxyxyyx(yx)xyxyyyx = xxyxyyx(xy)xyxyyyx
xxyxyyx(yxxy)xyyyx = xxyxyyx(xyyx)xyyyx
xxyxyyx(yx)xyyxxyy = xxyxyyx(xy)xyyxxyy
xxyxyyx(yxxy)yxxyy = xxyxyyx(xyyx)yxxyy
xxyxyyx(yx)xyyxyxy = xxyxyyx(xy)xyyxyxy
xxyxyyx(yx)xyyxyyx = xxyxyyx(xy)xyyxyyx
xxyxyyx(yx)xyyyxxy = xxyxyyx(xy)xyyyxxy
xxyxyyx(yx)xyyyxyx = xxyxyyx(xy)xyyyxyx
xxyxyyx(yx)xyyyyxx = xxyxyyx(xy)xyyyyxx
xxyxyyx(yx)yxxxyyy = xxyxyyx(xy)yxxxyyy
xxyxyyx(yx)yxxyxyy = xxyxyyx(xy)yxxyxyy
xxyxyyx(yxyx)xyyxy = xxyxyyx(xyxy)xyyxy
xxyxyyx(yx)yxxyyxy = xxyxyyx(xy)yxxyyxy
xxyxyyxyx(yx)xyyxy = xxyxyyxyx(xy)xyyxy
xxyxyyx(yxyx)xyyyx = xxyxyyx(xyxy)xyyyx
xxyxyyx(yx)yxxyyyx = xxyxyyx(xy)yxxyyyx
xxyxyyxyx(yx)xyyyx = xxyxyyxyx(xy)xyyyx
xxyxyyx(yxyx)yxxyy = xxyxyyx(xyxy)yxxyy
xxyxyyx(yx)yxyxxyy = xxyxyyx(xy)yxyxxyy
xxyxyyxyx(yx)yxxyy = xxyxyyxyx(xy)yxxyy
xxyxyyx(yx)yyxxxyy = xxyxyyx(xy)yyxxxyy
xxyxy(yx)yyxxxxyyy = xxyxy(xy)yyxxxxyyy
xxyxy(yx)yyxxxyxyy = xxyxy(xy)yyxxxyxyy
xxyxy(yx)yyxxxyyxy = xxyxy(xy)yyxxxyyxy
xxyxy(yx)yyxxxyyyx = xxyxy(xy)yyxxxyyyx
xxyxy(yx)yyxxyxxyy = xxyxy(xy)yyxxyxxyy
xxyxy(yx)yyxyxxxyy = xxyxy(xy)yyxyxxxyy
xxyxyyxyyx(yx)xyyx = xxyxyyxyyx(xy)xyyx
xxyxyyxyyx(yx)yxxy = xxyxyyxyyx(xy)yxxy
xxyxyyxy(yx)yyxxxy = xxyxyyxy(xy)yyxxxy
xxyxyyxy(yx)yyxxyx = xxyxyyxy(xy)yyxxyx
xxyxy(yx)yyyxxxxyy = xxyxy(xy)yyyxxxxyy
xxyxyyyxx(yx)xyxyy = xxyxyyyxx(xy)xyxyy
xxyxyyyxx(yx)xyyxy = xxyxyyyxx(xy)xyyxy
xxyxyyyxx(yx)xyyyx = xxyxyyyxx(xy)xyyyx
xxyxyyyxx(yx)yxxyy = xxyxyyyxx(xy)yxxyy
xxyxyyyxxy(yx)xyyx = xxyxyyyxxy(xy)xyyx
xxyxyyyxxy(yx)yxxy = xxyxyyyxxy(xy)yxxy
xxyxyyyx(yxx)xyyyx = xxyxyyyx(xxy)xyyyx
xxyxyyyx(yx)xxyyyx = xxyxyyyx(xy)xxyyyx
xxyxyyyx(yx)xyxyyx = xxyxyyyx(xy)xyxyyx
xxyxyyyx(yxxy)xyyx = xxyxyyyx(xyyx)xyyx
xxyxyyyx(yx)xyyxxy = xxyxyyyx(xy)xyyxxy
xxyxyyyx(yxxy)yxxy = xxyxyyyx(xyyx)yxxy
xxyxyyyx(yx)xyyxyx = xxyxyyyx(xy)xyyxyx
xxyxyyyx(yx)xyyyxx = xxyxyyyx(xy)xyyyxx
xxyxyyyx(yx)yxxxyy = xxyxyyyx(xy)yxxxyy
xxyxyyyx(yx)yxxyxy = xxyxyyyx(xy)yxxyxy
xxyxyyyx(yxyx)xyyx = xxyxyyyx(xyxy)xyyx
xxyxyyyx(yx)yxxyyx = xxyxyyyx(xy)yxxyyx
xxyxyyyxyx(yx)xyyx = xxyxyyyxyx(xy)xyyx
xxyxyyyx(yxyx)yxxy = xxyxyyyx(xyxy)yxxy
xxyxyyyx(yx)yxyxxy = xxyxyyyx(xy)yxyxxy
xxyxyyyxyx(yx)yxxy = xxyxyyyxyx(xy)yxxy
xxyxyyyx(yx)yxyxyx = xxyxyyyx(xy)yxyxyx
xxyxyyyx(yx)yyxxxy = xxyxyyyx(xy)yyxxxy
xxyxyyyx(yx)yyxxyx = xxyxyyyx(xy)yyxxyx
xxyxyy(yx)yyyxxxxy = xxyxyy(xy)yyyxxxxy
xxyxyy(yx)yyyxxxyx = xxyxyy(xy)yyyxxxyx
xxyxyy(yx)yyyxxyxx = xxyxyy(xy)yyyxxyxx
xxyxyyyyxx(yx)xyxy = xxyxyyyyxx(xy)xyxy
xxyxyyyyxx(yx)xyyx = xxyxyyyyxx(xy)xyyx
xxyxyyyyxx(yx)yxxy = xxyxyyyyxx(xy)yxxy
xxyxyyyyx(yx)xyyxx = xxyxyyyyx(xy)xyyxx
xxyxyyyyx(yx)yxxxy = xxyxyyyyx(xy)yxxxy
xxyxyyyyx(yx)yxxyx = xxyxyyyyx(xy)yxxyx
xxyxyyyyx(yx)yxyxx = xxyxyyyyx(xy)yxyxx
xxyxyyyyyxx(yx)xyx = xxyxyyyyyxx(xy)xyx
xxyyxxxxyy(yx)yxyy = xxyyxxxxyy(xy)yxyy
xxyyxxxxyyy(yx)yxy = xxyyxxxxyyy(xy)yxy
xxyyxxxyxyy(yx)yxy = xxyyxxxyxyy(xy)yxy
xxyyxxxy(yx)xyyxyy = xxyyxxxy(xy)xyyxyy
xxyyxxxy(yx)xyyyxy = xxyyxxxy(xy)xyyyxy
xxyyxxxy(yx)xyyyyx = xxyyxxxy(xy)xyyyyx
xxyyxxxy(yx)yxxyyy = xxyyxxxy(xy)yxxyyy
xxyyxxxyy(yx)xyyxy = xxyyxxxyy(xy)xyyxy
xxyyxxxyy(yx)xyyyx = xxyyxxxyy(xy)xyyyx
xxyyxxxyy(yx)yxxyy = xxyyxxxyy(xy)yxxyy
xxyyxxxyy(yx)yxyxy = xxyyxxxyy(xy)yxyxy
xxyyxxxyy(yx)yxyyx = xxyyxxxyy(xy)yxyyx
xxyyxxxyy(yx)yyxxy = xxyyxxxyy(xy)yyxxy
xxyyxx(yx)xxyyxyyy = xxyyxx(xy)xxyyxyyy
xxyyxx(yx)xxyyyxyy = xxyyxx(xy)xxyyyxyy
xxyyxx(yx)xxyyyyxy = xxyyxx(xy)xxyyyyxy
xxyyxx(yx)xxyyyyyx = xxyyxx(xy)xxyyyyyx
xxyyxx(yx)xyxxyyyy = xxyyxx(xy)xyxxyyyy
xxyyxxyxxyy(yx)yxy = xxyyxxyxxyy(xy)yxy
xxyyxx(yx)yxxxyyyy = xxyyxx(xy)yxxxyyyy
xxyyxxyxy(yx)xyyxy = xxyyxxyxy(xy)xyyxy
xxyyxxyxy(yx)xyyyx = xxyyxxyxy(xy)xyyyx
xxyyxxyxy(yx)yxxyy = xxyyxxyxy(xy)yxxyy
xxyyxxy(yx)xxyyyxy = xxyyxxy(xy)xxyyyxy
xxyyxxy(yx)xxyyyyx = xxyyxxy(xy)xxyyyyx
xxyyxxy(yx)xyxyyxy = xxyyxxy(xy)xyxyyxy
xxyyxxy(yxxy)xyyxy = xxyyxxy(xyyx)xyyxy
xxyyxxy(yx)xyxyyyx = xxyyxxy(xy)xyxyyyx
xxyyxxy(yxxy)xyyyx = xxyyxxy(xyyx)xyyyx
xxyyxxy(yx)xyyxxyy = xxyyxxy(xy)xyyxxyy
xxyyxxy(yxxy)yxxyy = xxyyxxy(xyyx)yxxyy
xxyyxxy(yx)xyyxyxy = xxyyxxy(xy)xyyxyxy
xxyyxxy(yx)xyyxyyx = xxyyxxy(xy)xyyxyyx
xxyyxxy(yx)xyyyxxy = xxyyxxy(xy)xyyyxxy
xxyyxxy(yx)xyyyxyx = xxyyxxy(xy)xyyyxyx
xxyyxxy(yx)xyyyyxx = xxyyxxy(xy)xyyyyxx
xxyyxxy(yx)yxxxyyy = xxyyxxy(xy)yxxxyyy
xxyyxxy(yx)yxxyxyy = xxyyxxy(xy)yxxyxyy
xxyyxxy(yxyx)xyyxy = xxyyxxy(xyxy)xyyxy
xxyyxxy(yx)yxxyyxy = xxyyxxy(xy)yxxyyxy
xxyyxxyyx(yx)xyyxy = xxyyxxyyx(xy)xyyxy
xxyyxxy(yxyx)xyyyx = xxyyxxy(xyxy)xyyyx
xxyyxxy(yx)yxxyyyx = xxyyxxy(xy)yxxyyyx
xxyyxxyyx(yx)xyyyx = xxyyxxyyx(xy)xyyyx
xxyyxxy(yxyx)yxxyy = xxyyxxy(xyxy)yxxyy
xxyyxxy(yx)yxyxxyy = xxyyxxy(xy)yxyxxyy
xxyyxxyyx(yx)yxxyy = xxyyxxyyx(xy)yxxyy
xxyyxxy(yx)yyxxxyy = xxyyxxy(xy)yyxxxyy
xxyyxxyy(yx)xyyyxx = xxyyxxyy(xy)xyyyxx
xxyyxxyyyx(yx)xyyx = xxyyxxyyyx(xy)xyyx
xxyyxxyyyx(yx)yxxy = xxyyxxyyyx(xy)yxxy
xxyyxxyy(yx)yxyyxx = xxyyxxyy(xy)yxyyxx
xxyyxxyy(yx)yyxxxy = xxyyxxyy(xy)yyxxxy
xxyyxxyy(yx)yyxxyx = xxyyxxyy(xy)yyxxyx
xxyyx(yxx)xxyyyyxy = xxyyx(xxy)xxyyyyxy
xxyyx(yx)xxxyyyyxy = xxyyx(xy)xxxyyyyxy
xxyyx(yxx)xxyyyyyx = xxyyx(xxy)xxyyyyyx
xxyyx(yx)xxxyyyyyx = xxyyx(xy)xxxyyyyyx
xxyyx(yx)xxyxyyyxy = xxyyx(xy)xxyxyyyxy
xxyyx(yx)xxyxyyyyx = xxyyx(xy)xxyxyyyyx
xxyyx(yx)xxyyxyyxy = xxyyx(xy)xxyyxyyxy
xxyyx(yxxxyyxy)yxy = xxyyx(xyxxyyyx)yxy
xxyyx(yx)xxyyxyyyx = xxyyx(xy)xxyyxyyyx
xxyyx(yx)xxyyyxxyy = xxyyx(xy)xxyyyxxyy
xxyyx(yxxxyyyx)yxy = xxyyx(xyxxyyxy)yxy
xxyyx(yx)xxyyyxyxy = xxyyx(xy)xxyyyxyxy
xxyyxyxxxyy(yx)yxy = xxyyxyxxxyy(xy)yxy
xxyyx(yx)xxyyyxyyx = xxyyx(xy)xxyyyxyyx
xxyyx(yx)xxyyyyxxy = xxyyx(xy)xxyyyyxxy
xxyyx(yx)xxyyyyxyx = xxyyx(xy)xxyyyyxyx
xxyyx(yx)xxyyyyyxx = xxyyx(xy)xxyyyyyxx
xxyyx(yx)xyxxyyyxy = xxyyx(xy)xyxxyyyxy
xxyyx(yxxy)xxyyyxy = xxyyx(xyyx)xxyyyxy
xxyyx(yx)xyxxyyyyx = xxyyx(xy)xyxxyyyyx
xxyyx(yxxy)xxyyyyx = xxyyx(xyyx)xxyyyyx
xxyyx(yx)xyxyxyyxy = xxyyx(xy)xyxyxyyxy
xxyyx(yxxyxy)xyyxy = xxyyx(xyxyyx)xyyxy
xxyyx(yxxy)xyxyyxy = xxyyx(xyyx)xyxyyxy
xxyyx(yxxyxy)xyyxy = xxyyx(xyyxyx)xyyxy
xxyyx(yx)xyxyxyyyx = xxyyx(xy)xyxyxyyyx
xxyyx(yxxyxy)xyyyx = xxyyx(xyxyyx)xyyyx
xxyyx(yxxy)xyxyyyx = xxyyx(xyyx)xyxyyyx
xxyyx(yxxyxy)xyyyx = xxyyx(xyyxyx)xyyyx
xxyyx(yx)xyxyyxxyy = xxyyx(xy)xyxyyxxyy
xxyyx(yxxyxy)yxxyy = xxyyx(xyxyyx)yxxyy
xxyyx(yxxy)xyyxxyy = xxyyx(xyyx)xyyxxyy
xxyyx(yxxyxy)yxxyy = xxyyx(xyyxyx)yxxyy
xxyyx(yx)xyxyyxyxy = xxyyx(xy)xyxyyxyxy
xxyyx(yxxy)xyyxyxy = xxyyx(xyyx)xyyxyxy
xxyyx(yx)xyxyyxyyx = xxyyx(xy)xyxyyxyyx
xxyyx(yxxy)xyyxyyx = xxyyx(xyyx)xyyxyyx
xxyyx(yx)xyxyyyxxy = xxyyx(xy)xyxyyyxxy
xxyyx(yxxy)xyyyxxy = xxyyx(xyyx)xyyyxxy
xxyyx(yx)xyxyyyxyx = xxyyx(xy)xyxyyyxyx
xxyyx(yxxy)xyyyxyx = xxyyx(xyyx)xyyyxyx
xxyyx(yx)xyxyyyyxx = xxyyx(xy)xyxyyyyxx
xxyyx(yxxy)xyyyyxx = xxyyx(xyyx)xyyyyxx
xxyyx(yx)xyyxxxyyy = xxyyx(xy)xyyxxxyyy
xxyyx(yxxy)yxxxyyy = xxyyx(xyyx)yxxxyyy
xxyyx(yx)xyyxxyxyy = xxyyx(xy)xyyxxyxyy
xxyyx(yxxy)yxxyxyy = xxyyx(xyyx)yxxyxyy
xxyyx(yxxyyx)xyyxy = xxyyx(xyxyxy)xyyxy
xxyyx(yx)xyyxxyyxy = xxyyx(xy)xyyxxyyxy
xxyyx(yxxyyx)xyyxy = xxyyx(xyyxxy)xyyxy
xxyyx(yxxy)yxxyyxy = xxyyx(xyyx)yxxyyxy
xxyyxyxxy(yx)xyyxy = xxyyxyxxy(xy)xyyxy
xxyyx(yxxyyx)xyyyx = xxyyx(xyxyxy)xyyyx
xxyyx(yx)xyyxxyyyx = xxyyx(xy)xyyxxyyyx
xxyyx(yxxyyx)xyyyx = xxyyx(xyyxxy)xyyyx
xxyyx(yxxy)yxxyyyx = xxyyx(xyyx)yxxyyyx
xxyyxyxxy(yx)xyyyx = xxyyxyxxy(xy)xyyyx
xxyyx(yxxyyx)yxxyy = xxyyx(xyxyxy)yxxyy
xxyyx(yx)xyyxyxxyy = xxyyx(xy)xyyxyxxyy
xxyyx(yxxyyx)yxxyy = xxyyx(xyyxxy)yxxyy
xxyyx(yxxy)yxyxxyy = xxyyx(xyyx)yxyxxyy
xxyyxyxxy(yx)yxxyy = xxyyxyxxy(xy)yxxyy
xxyyx(yx)xyyxyxyxy = xxyyx(xy)xyyxyxyxy
xxyyx(yx)xyyxyxyyx = xxyyx(xy)xyyxyxyyx
xxyyx(yx)xyyxyyxxy = xxyyx(xy)xyyxyyxxy
xxyyx(yx)xyyxyyxyx = xxyyx(xy)xyyxyyxyx
xxyyx(yx)xyyxyyyxx = xxyyx(xy)xyyxyyyxx
xxyyx(yx)xyyyxxxyy = xxyyx(xy)xyyyxxxyy
xxyyx(yxxy)yyxxxyy = xxyyx(xyyx)yyxxxyy
xxyyx(yx)xyyyxxyxy = xxyyx(xy)xyyyxxyxy
xxyyx(yx)xyyyxxyyx = xxyyx(xy)xyyyxxyyx
xxyyx(yx)xyyyxyxxy = xxyyx(xy)xyyyxyxxy
xxyyx(yx)xyyyxyxyx = xxyyx(xy)xyyyxyxyx
xxyyx(yx)xyyyxyyxx = xxyyx(xy)xyyyxyyxx
xxyyx(yx)xyyyyxxxy = xxyyx(xy)xyyyyxxxy
xxyyx(yx)xyyyyxxyx = xxyyx(xy)xyyyyxxyx
xxyyx(yx)xyyyyxyxx = xxyyx(xy)xyyyyxyxx
xxyyx(yx)xyyyyyxxx = xxyyx(xy)xyyyyyxxx
xxyyx(yx)yxxxxyyyy = xxyyx(xy)yxxxxyyyy
xxyyx(yx)yxxxyxyyy = xxyyx(xy)yxxxyxyyy
xxyyx(yx)yxxxyyxyy = xxyyx(xy)yxxxyyxyy
xxyyx(yxyx)xxyyyxy = xxyyx(xyxy)xxyyyxy
xxyyx(yx)yxxxyyyxy = xxyyx(xy)yxxxyyyxy
xxyyxyx(yx)xxyyyxy = xxyyxyx(xy)xxyyyxy
xxyyx(yxyx)xxyyyyx = xxyyx(xyxy)xxyyyyx
xxyyx(yx)yxxxyyyyx = xxyyx(xy)yxxxyyyyx
xxyyxyx(yx)xxyyyyx = xxyyxyx(xy)xxyyyyx
xxyyx(yx)yxxyxxyyy = xxyyx(xy)yxxyxxyyy
xxyyx(yx)yxxyxyxyy = xxyyx(xy)yxxyxyxyy
xxyyx(yxyx)xyxyyxy = xxyyx(xyxy)xyxyyxy
xxyyx(yxyxxy)xyyxy = xxyyx(xyxyyx)xyyxy
xxyyx(yx)yxxyxyyxy = xxyyx(xy)yxxyxyyxy
xxyyx(yxyxxy)xyyxy = xxyyx(xyyxyx)xyyxy
xxyyxyx(yx)xyxyyxy = xxyyxyx(xy)xyxyyxy
xxyyxyx(yxxy)xyyxy = xxyyxyx(xyyx)xyyxy
xxyyx(yxyx)xyxyyyx = xxyyx(xyxy)xyxyyyx
xxyyx(yxyxxy)xyyyx = xxyyx(xyxyyx)xyyyx
xxyyx(yx)yxxyxyyyx = xxyyx(xy)yxxyxyyyx
xxyyx(yxyxxy)xyyyx = xxyyx(xyyxyx)xyyyx
xxyyxyx(yx)xyxyyyx = xxyyxyx(xy)xyxyyyx
xxyyxyx(yxxy)xyyyx = xxyyxyx(xyyx)xyyyx
xxyyx(yxyx)xyyxxyy = xxyyx(xyxy)xyyxxyy
xxyyx(yxyxxy)yxxyy = xxyyx(xyxyyx)yxxyy
xxyyx(yx)yxxyyxxyy = xxyyx(xy)yxxyyxxyy
xxyyx(yxyxxy)yxxyy = xxyyx(xyyxyx)yxxyy
xxyyxyx(yx)xyyxxyy = xxyyxyx(xy)xyyxxyy
xxyyxyx(yxxy)yxxyy = xxyyxyx(xyyx)yxxyy
xxyyx(yxyx)xyyxyxy = xxyyx(xyxy)xyyxyxy
xxyyx(yx)yxxyyxyxy = xxyyx(xy)yxxyyxyxy
xxyyxyx(yx)xyyxyxy = xxyyxyx(xy)xyyxyxy
xxyyx(yxyx)xyyxyyx = xxyyx(xyxy)xyyxyyx
xxyyx(yx)yxxyyxyyx = xxyyx(xy)yxxyyxyyx
xxyyxyx(yx)xyyxyyx = xxyyxyx(xy)xyyxyyx
xxyyx(yxyx)xyyyxxy = xxyyx(xyxy)xyyyxxy
xxyyx(yx)yxxyyyxxy = xxyyx(xy)yxxyyyxxy
xxyyxyx(yx)xyyyxxy = xxyyxyx(xy)xyyyxxy
xxyyx(yxyx)xyyyxyx = xxyyx(xyxy)xyyyxyx
xxyyx(yx)yxxyyyxyx = xxyyx(xy)yxxyyyxyx
xxyyxyx(yx)xyyyxyx = xxyyxyx(xy)xyyyxyx
xxyyx(yxyx)xyyyyxx = xxyyx(xyxy)xyyyyxx
xxyyx(yx)yxxyyyyxx = xxyyx(xy)yxxyyyyxx
xxyyxyx(yx)xyyyyxx = xxyyxyx(xy)xyyyyxx
xxyyx(yxyx)yxxxyyy = xxyyx(xyxy)yxxxyyy
xxyyx(yx)yxyxxxyyy = xxyyx(xy)yxyxxxyyy
xxyyxyx(yx)yxxxyyy = xxyyxyx(xy)yxxxyyy
xxyyx(yxyx)yxxyxyy = xxyyx(xyxy)yxxyxyy
xxyyx(yx)yxyxxyxyy = xxyyx(xy)yxyxxyxyy
xxyyxyx(yx)yxxyxyy = xxyyxyx(xy)yxxyxyy
xxyyx(yxyxyx)xyyxy = xxyyx(xyxyxy)xyyxy
xxyyx(yxyx)yxxyyxy = xxyyx(xyxy)yxxyyxy
xxyyx(yxyxyx)xyyxy = xxyyx(xyyxxy)xyyxy
xxyyx(yx)yxyxxyyxy = xxyyx(xy)yxyxxyyxy
xxyyxyx(yxyx)xyyxy = xxyyxyx(xyxy)xyyxy
xxyyxyx(yx)yxxyyxy = xxyyxyx(xy)yxxyyxy
xxyyxyxyx(yx)xyyxy = xxyyxyxyx(xy)xyyxy
xxyyx(yxyxyx)xyyyx = xxyyx(xyxyxy)xyyyx
xxyyx(yxyx)yxxyyyx = xxyyx(xyxy)yxxyyyx
xxyyx(yxyxyx)xyyyx = xxyyx(xyyxxy)xyyyx
xxyyx(yx)yxyxxyyyx = xxyyx(xy)yxyxxyyyx
xxyyxyx(yxyx)xyyyx = xxyyxyx(xyxy)xyyyx
xxyyxyx(yx)yxxyyyx = xxyyxyx(xy)yxxyyyx
xxyyxyxyx(yx)xyyyx = xxyyxyxyx(xy)xyyyx
xxyyx(yxyxyx)yxxyy = xxyyx(xyxyxy)yxxyy
xxyyx(yxyx)yxyxxyy = xxyyx(xyxy)yxyxxyy
xxyyx(yxyxyx)yxxyy = xxyyx(xyyxxy)yxxyy
xxyyx(yx)yxyxyxxyy = xxyyx(xy)yxyxyxxyy
xxyyxyx(yxyx)yxxyy = xxyyxyx(xyxy)yxxyy
xxyyxyx(yx)yxyxxyy = xxyyxyx(xy)yxyxxyy
xxyyxyxyx(yx)yxxyy = xxyyxyxyx(xy)yxxyy
xxyyx(yxyx)yyxxxyy = xxyyx(xyxy)yyxxxyy
xxyyx(yx)yxyyxxxyy = xxyyx(xy)yxyyxxxyy
xxyyxyx(yx)yyxxxyy = xxyyxyx(xy)yyxxxyy
xxyyx(yx)yyxxxxyyy = xxyyx(xy)yyxxxxyyy
xxyyx(yx)yyxxxyxyy = xxyyx(xy)yyxxxyxyy
xxyyx(yx)yyxxxyyxy = xxyyx(xy)yyxxxyyxy
xxyyx(yx)yyxxxyyyx = xxyyx(xy)yyxxxyyyx
xxyyx(yx)yyxxyxxyy = xxyyx(xy)yyxxyxxyy
xxyyxyxy(yx)xyyyxx = xxyyxyxy(xy)xyyyxx
xxyyx(yx)yyxyxxxyy = xxyyx(xy)yyxyxxxyy
xxyyxyxyyx(yx)xyyx = xxyyxyxyyx(xy)xyyx
xxyyxyxyyx(yx)yxxy = xxyyxyxyyx(xy)yxxy
xxyyxyxy(yx)yyxxxy = xxyyxyxy(xy)yyxxxy
xxyyx(yx)yyyxxxxyy = xxyyx(xy)yyyxxxxyy
xxyyxyyxx(yx)xyxyy = xxyyxyyxx(xy)xyxyy
xxyyxyyxx(yx)xyyxy = xxyyxyyxx(xy)xyyxy
xxyyxyyxx(yx)xyyyx = xxyyxyyxx(xy)xyyyx
xxyyxyyxx(yx)yxxyy = xxyyxyyxx(xy)yxxyy
xxyyxyyxxy(yx)xyyx = xxyyxyyxxy(xy)xyyx
xxyyxyyxxy(yx)yxxy = xxyyxyyxxy(xy)yxxy
xxyyxy(yx)xyyyyxxx = xxyyxy(xy)xyyyyxxx
xxyyxyyx(yxx)xyyyx = xxyyxyyx(xxy)xyyyx
xxyyxyyx(yx)xxyyyx = xxyyxyyx(xy)xxyyyx
xxyyxyyx(yx)xyxyyx = xxyyxyyx(xy)xyxyyx
xxyyxyyx(yxxy)xyyx = xxyyxyyx(xyyx)xyyx
xxyyxyyx(yx)xyyxxy = xxyyxyyx(xy)xyyxxy
xxyyxyyx(yxxy)yxxy = xxyyxyyx(xyyx)yxxy
xxyyxyyx(yx)xyyxyx = xxyyxyyx(xy)xyyxyx
xxyyxyyx(yx)xyyyxx = xxyyxyyx(xy)xyyyxx
xxyyxyyx(yx)yxxxyy = xxyyxyyx(xy)yxxxyy
xxyyxyyx(yx)yxxyxy = xxyyxyyx(xy)yxxyxy
xxyyxyyx(yxyx)xyyx = xxyyxyyx(xyxy)xyyx
xxyyxyyx(yx)yxxyyx = xxyyxyyx(xy)yxxyyx
xxyyxyyxyx(yx)xyyx = xxyyxyyxyx(xy)xyyx
xxyyxyyx(yxyx)yxxy = xxyyxyyx(xyxy)yxxy
xxyyxyyx(yx)yxyxxy = xxyyxyyx(xy)yxyxxy
xxyyxyyxyx(yx)yxxy = xxyyxyyxyx(xy)yxxy
xxyyxyyx(yx)yyxxxy = xxyyxyyx(xy)yyxxxy
xxyyx(yyx)yyxxxxyy = xxyyx(xyy)yyxxxxyy
xxyyxy(yx)yyxxxxyy = xxyyxy(xy)yyxxxxyy
xxyyxy(yx)yyxxxyxy = xxyyxy(xy)yyxxxyxy
xxyyxy(yx)yyxxxyyx = xxyyxy(xy)yyxxxyyx
xxyyxy(yx)yyxxyxxy = xxyyxy(xy)yyxxyxxy
xxyyxy(yx)yyxxyxyx = xxyyxy(xy)yyxxyxyx
xxyyxy(yx)yyxxyyxx = xxyyxy(xy)yyxxyyxx
xxyyxy(yx)yyxyxxxy = xxyyxy(xy)yyxyxxxy
xxyyxy(yx)yyxyxxyx = xxyyxy(xy)yyxyxxyx
xxyyxy(yx)yyyxxxxy = xxyyxy(xy)yyyxxxxy
xxyyxy(yx)yyyxxxyx = xxyyxy(xy)yyyxxxyx
xxyyxyyyxx(yx)xyxy = xxyyxyyyxx(xy)xyxy
xxyyxyyyxx(yx)xyyx = xxyyxyyyxx(xy)xyyx
xxyyxyyyxx(yx)yxxy = xxyyxyyyxx(xy)yxxy
xxyyxyyyx(yx)xyyxx = xxyyxyyyx(xy)xyyxx
xxyyxyyyx(yx)yxxxy = xxyyxyyyx(xy)yxxxy
xxyyxyyyx(yx)yxxyx = xxyyxyyyx(xy)yxxyx
xxyyxyyyyxx(yx)xyx = xxyyxyyyyxx(xy)xyx
xxyyyxxxxyy(yx)yxy = xxyyyxxxxyy(xy)yxy
xxyyyxxxy(yx)xyyxy = xxyyyxxxy(xy)xyyxy
xxyyyxxxy(yx)xyyyx = xxyyyxxxy(xy)xyyyx
xxyyyxxxy(yx)yxxyy = xxyyyxxxy(xy)yxxyy
xxyyyxxxyy(yx)xyyx = xxyyyxxxyy(xy)xyyx
xxyyyxxxyy(yx)yxxy = xxyyyxxxyy(xy)yxxy
xxyyyxxxyy(yx)yxyx = xxyyyxxxyy(xy)yxyx
xxyyyxx(yx)xxyyxyy = xxyyyxx(xy)xxyyxyy
xxyyyxx(yx)xxyyyxy = xxyyyxx(xy)xxyyyxy
xxyyyxx(yx)xxyyyyx = xxyyyxx(xy)xxyyyyx
xxyyyxx(yx)xyxxyyy = xxyyyxx(xy)xyxxyyy
xxyyyxx(yx)xyxyxyy = xxyyyxx(xy)xyxyxyy
xxyyyxx(yx)xyxyyxy = xxyyyxx(xy)xyxyyxy
xxyyyxx(yxxy)xyyxy = xxyyyxx(xyyx)xyyxy
xxyyyxx(yx)xyxyyyx = xxyyyxx(xy)xyxyyyx
xxyyyxx(yxxy)xyyyx = xxyyyxx(xyyx)xyyyx
xxyyyxx(yx)xyyxxyy = xxyyyxx(xy)xyyxxyy
xxyyyxx(yxxy)yxxyy = xxyyyxx(xyyx)yxxyy
xxyyyxx(yx)xyyxyxy = xxyyyxx(xy)xyyxyxy
xxyyyxx(yx)xyyxyyx = xxyyyxx(xy)xyyxyyx
xxyyyxx(yx)xyyyxxy = xxyyyxx(xy)xyyyxxy
xxyyyxx(yx)xyyyxyx = xxyyyxx(xy)xyyyxyx
xxyyyxx(yx)xyyyyxx = xxyyyxx(xy)xyyyyxx
xxyyyxx(yx)yxxxyyy = xxyyyxx(xy)yxxxyyy
xxyyyxx(yx)yxxyxyy = xxyyyxx(xy)yxxyxyy
xxyyyxx(yxyx)xyyxy = xxyyyxx(xyxy)xyyxy
xxyyyxx(yx)yxxyyxy = xxyyyxx(xy)yxxyyxy
xxyyyxxyx(yx)xyyxy = xxyyyxxyx(xy)xyyxy
xxyyyxx(yxyx)xyyyx = xxyyyxx(xyxy)xyyyx
xxyyyxx(yx)yxxyyyx = xxyyyxx(xy)yxxyyyx
xxyyyxxyx(yx)xyyyx = xxyyyxxyx(xy)xyyyx
xxyyyxx(yxyx)yxxyy = xxyyyxx(xyxy)yxxyy
xxyyyxx(yx)yxyxxyy = xxyyyxx(xy)yxyxxyy
xxyyyxxyx(yx)yxxyy = xxyyyxxyx(xy)yxxyy
xxyyyxx(yx)yyxxxyy = xxyyyxx(xy)yyxxxyy
xxyyyxxyxy(yx)xyyx = xxyyyxxyxy(xy)xyyx
xxyyyxxyxy(yx)yxxy = xxyyyxxyxy(xy)yxxy
xxyyyxx(yyxx)xyyyx = xxyyyxx(xyxy)xyyyx
xxyyyxx(yyx)xxyyyx = xxyyyxx(xyy)xxyyyx
xxyyyxxy(yxx)xyyyx = xxyyyxxy(xxy)xyyyx
xxyyyxxy(yx)xxyyyx = xxyyyxxy(xy)xxyyyx
xxyyyxxy(yx)xyxyyx = xxyyyxxy(xy)xyxyyx
xxyyyxxy(yxxy)xyyx = xxyyyxxy(xyyx)xyyx
xxyyyxxy(yx)xyyxxy = xxyyyxxy(xy)xyyxxy
xxyyyxxy(yxxy)yxxy = xxyyyxxy(xyyx)yxxy
xxyyyxxy(yx)xyyxyx = xxyyyxxy(xy)xyyxyx
xxyyyxxy(yx)xyyyxx = xxyyyxxy(xy)xyyyxx
xxyyyxx(yyx)yxxxyy = xxyyyxx(xyy)yxxxyy
xxyyyxxy(yx)yxxxyy = xxyyyxxy(xy)yxxxyy
xxyyyxxy(yx)yxxyxy = xxyyyxxy(xy)yxxyxy
xxyyyxxy(yxyx)xyyx = xxyyyxxy(xyxy)xyyx
xxyyyxxy(yx)yxxyyx = xxyyyxxy(xy)yxxyyx
xxyyyxxyyx(yx)xyyx = xxyyyxxyyx(xy)xyyx
xxyyyxxy(yxyx)yxxy = xxyyyxxy(xyxy)yxxy
xxyyyxxy(yx)yxyxxy = xxyyyxxy(xy)yxyxxy
xxyyyxxyyx(yx)yxxy = xxyyyxxyyx(xy)yxxy
xxyyyxxy(yx)yyxxxy = xxyyyxxy(xy)yyxxxy
xxyyyx(yxx)xxyyyyx = xxyyyx(xxy)xxyyyyx
xxyyyx(yx)xxxyyyyx = xxyyyx(xy)xxxyyyyx
xxyyyx(yxx)xyxyyyx = xxyyyx(xxy)xyxyyyx
xxyyyx(yxxxy)xyyyx = xxyyyx(xxyyx)xyyyx
xxyyyx(yx)xxyxyyyx = xxyyyx(xy)xxyxyyyx
xxyyyx(yxxxy)xyyyx = xxyyyx(xyxyx)xyyyx
xxyyyx(yxxxy)xyyyx = xxyyyx(xyyxx)xyyyx
xxyyyx(yxx)xyyxyyx = xxyyyx(xxy)xyyxyyx
xxyyyx(yx)xxyyxyyx = xxyyyx(xy)xxyyxyyx
xxyyyx(yxx)xyyyxxy = xxyyyx(xxy)xyyyxxy
xxyyyx(yx)xxyyyxxy = xxyyyx(xy)xxyyyxxy
xxyyyx(yxx)xyyyxyx = xxyyyx(xxy)xyyyxyx
xxyyyx(yx)xxyyyxyx = xxyyyx(xy)xxyyyxyx
xxyyyx(yxx)xyyyyxx = xxyyyx(xxy)xyyyyxx
xxyyyx(yx)xxyyyyxx = xxyyyx(xy)xxyyyyxx
xxyyyxyxx(yx)xyxyy = xxyyyxyxx(xy)xyxyy
xxyyyxyxx(yx)xyyxy = xxyyyxyxx(xy)xyyxy
xxyyyx(yxxyx)xyyyx = xxyyyx(xxyxy)xyyyx
xxyyyx(yxx)yxxyyyx = xxyyyx(xxy)yxxyyyx
xxyyyx(yxxyx)xyyyx = xxyyyx(xyxxy)xyyyx
xxyyyx(yx)xyxxyyyx = xxyyyx(xy)xyxxyyyx
xxyyyx(yxxy)xxyyyx = xxyyyx(xyyx)xxyyyx
xxyyyxyxx(yx)xyyyx = xxyyyxyxx(xy)xyyyx
xxyyyxyxx(yx)yxxyy = xxyyyxyxx(xy)yxxyy
xxyyyx(yx)xyxyxyyx = xxyyyx(xy)xyxyxyyx
xxyyyx(yxxyxy)xyyx = xxyyyx(xyxyyx)xyyx
xxyyyx(yxxy)xyxyyx = xxyyyx(xyyx)xyxyyx
xxyyyx(yxxyxy)xyyx = xxyyyx(xyyxyx)xyyx
xxyyyx(yx)xyxyyxxy = xxyyyx(xy)xyxyyxxy
xxyyyx(yxxyxy)yxxy = xxyyyx(xyxyyx)yxxy
xxyyyx(yxxy)xyyxxy = xxyyyx(xyyx)xyyxxy
xxyyyx(yxxyxy)yxxy = xxyyyx(xyyxyx)yxxy
xxyyyx(yx)xyxyyxyx = xxyyyx(xy)xyxyyxyx
xxyyyx(yxxy)xyyxyx = xxyyyx(xyyx)xyyxyx
xxyyyx(yx)xyxyyyxx = xxyyyx(xy)xyxyyyxx
xxyyyx(yxxy)xyyyxx = xxyyyx(xyyx)xyyyxx
xxyyyx(yxx)yyxxxyy = xxyyyx(xxy)yyxxxyy
xxyyyx(yx)xyyxxxyy = xxyyyx(xy)xyyxxxyy
xxyyyx(yxxy)yxxxyy = xxyyyx(xyyx)yxxxyy
xxyyyx(yx)xyyxxyxy = xxyyyx(xy)xyyxxyxy
xxyyyx(yxxy)yxxyxy = xxyyyx(xyyx)yxxyxy
xxyyyx(yxxyyx)xyyx = xxyyyx(xyxyxy)xyyx
xxyyyx(yx)xyyxxyyx = xxyyyx(xy)xyyxxyyx
xxyyyx(yxxyyx)xyyx = xxyyyx(xyyxxy)xyyx
xxyyyx(yxxy)yxxyyx = xxyyyx(xyyx)yxxyyx
xxyyyxyxxy(yx)xyyx = xxyyyxyxxy(xy)xyyx
xxyyyx(yxxyyx)yxxy = xxyyyx(xyxyxy)yxxy
xxyyyx(yx)xyyxyxxy = xxyyyx(xy)xyyxyxxy
xxyyyx(yxxyyx)yxxy = xxyyyx(xyyxxy)yxxy
xxyyyx(yxxy)yxyxxy = xxyyyx(xyyx)yxyxxy
xxyyyxyxxy(yx)yxxy = xxyyyxyxxy(xy)yxxy
xxyyyx(yx)xyyxyxyx = xxyyyx(xy)xyyxyxyx
xxyyyx(yx)xyyxyyxx = xxyyyx(xy)xyyxyyxx
xxyyyx(yx)xyyyxxxy = xxyyyx(xy)xyyyxxxy
xxyyyx(yxxy)yyxxxy = xxyyyx(xyyx)yyxxxy
xxyyyx(yx)xyyyxxyx = xxyyyx(xy)xyyyxxyx
xxyyyx(yx)xyyyxyxx = xxyyyx(xy)xyyyxyxx
xxyyyx(yx)xyyyyxxx = xxyyyx(xy)xyyyyxxx
xxyyyx(yx)yxxxxyyy = xxyyyx(xy)yxxxxyyy
xxyyyx(yx)yxxxyxyy = xxyyyx(xy)yxxxyxyy
xxyyyx(yx)yxxxyyxy = xxyyyx(xy)yxxxyyxy
xxyyyx(yxyxx)xyyyx = xxyyyx(xxyxy)xyyyx
xxyyyx(yxyx)xxyyyx = xxyyyx(xxyy)xxyyyx
xxyyyx(yxyxx)xyyyx = xxyyyx(xyxxy)xyyyx
xxyyyx(yxyx)xxyyyx = xxyyyx(xyxy)xxyyyx
xxyyyx(yx)yxxxyyyx = xxyyyx(xy)yxxxyyyx
xxyyyxyx(yxx)xyyyx = xxyyyxyx(xxy)xyyyx
xxyyyxyx(yx)xxyyyx = xxyyyxyx(xy)xxyyyx
xxyyyx(yx)yxxyxxyy = xxyyyx(xy)yxxyxxyy
xxyyyx(yx)yxxyxyxy = xxyyyx(xy)yxxyxyxy
xxyyyx(yxyx)xyxyyx = xxyyyx(xyxy)xyxyyx
xxyyyx(yxyxxy)xyyx = xxyyyx(xyxyyx)xyyx
xxyyyx(yx)yxxyxyyx = xxyyyx(xy)yxxyxyyx
xxyyyx(yxyxxy)xyyx = xxyyyx(xyyxyx)xyyx
xxyyyxyx(yx)xyxyyx = xxyyyxyx(xy)xyxyyx
xxyyyxyx(yxxy)xyyx = xxyyyxyx(xyyx)xyyx
xxyyyx(yxyx)xyyxxy = xxyyyx(xyxy)xyyxxy
xxyyyx(yxyxxy)yxxy = xxyyyx(xyxyyx)yxxy
xxyyyx(yx)yxxyyxxy = xxyyyx(xy)yxxyyxxy
xxyyyx(yxyxxy)yxxy = xxyyyx(xyyxyx)yxxy
xxyyyxyx(yx)xyyxxy = xxyyyxyx(xy)xyyxxy
xxyyyxyx(yxxy)yxxy = xxyyyxyx(xyyx)yxxy
xxyyyx(yxyx)xyyxyx = xxyyyx(xyxy)xyyxyx
xxyyyx(yx)yxxyyxyx = xxyyyx(xy)yxxyyxyx
xxyyyxyx(yx)xyyxyx = xxyyyxyx(xy)xyyxyx
xxyyyx(yxyx)xyyyxx = xxyyyx(xyxy)xyyyxx
xxyyyx(yx)yxxyyyxx = xxyyyx(xy)yxxyyyxx
xxyyyxyx(yx)xyyyxx = xxyyyxyx(xy)xyyyxx
xxyyyx(yxyx)yxxxyy = xxyyyx(xxyy)yxxxyy
xxyyyx(yxyx)yxxxyy = xxyyyx(xyxy)yxxxyy
xxyyyx(yx)yxyxxxyy = xxyyyx(xy)yxyxxxyy
xxyyyxyx(yx)yxxxyy = xxyyyxyx(xy)yxxxyy
xxyyyx(yxyx)yxxyxy = xxyyyx(xyxy)yxxyxy
xxyyyx(yx)yxyxxyxy = xxyyyx(xy)yxyxxyxy
xxyyyxyx(yx)yxxyxy = xxyyyxyx(xy)yxxyxy
xxyyyx(yxyxyx)xyyx = xxyyyx(xyxyxy)xyyx
xxyyyx(yxyx)yxxyyx = xxyyyx(xyxy)yxxyyx
xxyyyx(yxyxyx)xyyx = xxyyyx(xyyxxy)xyyx
xxyyyx(yx)yxyxxyyx = xxyyyx(xy)yxyxxyyx
xxyyyxyx(yxyx)xyyx = xxyyyxyx(xyxy)xyyx
xxyyyxyx(yx)yxxyyx = xxyyyxyx(xy)yxxyyx
xxyyyxyxyx(yx)xyyx = xxyyyxyxyx(xy)xyyx
xxyyyx(yxyxyx)yxxy = xxyyyx(xyxyxy)yxxy
xxyyyx(yxyx)yxyxxy = xxyyyx(xyxy)yxyxxy
xxyyyx(yxyxyx)yxxy = xxyyyx(xyyxxy)yxxy
xxyyyx(yx)yxyxyxxy = xxyyyx(xy)yxyxyxxy
xxyyyxyx(yxyx)yxxy = xxyyyxyx(xyxy)yxxy
xxyyyxyx(yx)yxyxxy = xxyyyxyx(xy)yxyxxy
xxyyyxyxyx(yx)yxxy = xxyyyxyxyx(xy)yxxy
xxyyyx(yx)yxyxyxyx = xxyyyx(xy)yxyxyxyx
xxyyyx(yx)yxyxyyxx = xxyyyx(xy)yxyxyyxx
xxyyyx(yxyx)yyxxxy = xxyyyx(xyxy)yyxxxy
xxyyyx(yx)yxyyxxxy = xxyyyx(xy)yxyyxxxy
xxyyyxyx(yx)yyxxxy = xxyyyxyx(xy)yyxxxy
xxyyyx(yx)yxyyxxyx = xxyyyx(xy)yxyyxxyx
xxyyyx(yx)yyxxxxyy = xxyyyx(xy)yyxxxxyy
xxyyyx(yx)yyxxxyxy = xxyyyx(xy)yyxxxyxy
xxyyyx(yx)yyxxxyyx = xxyyyx(xy)yyxxxyyx
xxyyyx(yx)yyxxyxxy = xxyyyx(xy)yyxxyxxy
xxyyyx(yx)yyxxyxyx = xxyyyx(xy)yyxxyxyx
xxyyyx(yx)yyxxyyxx = xxyyyx(xy)yyxxyyxx
xxyyyx(yx)yyxyxxxy = xxyyyx(xy)yyxyxxxy
xxyyyx(yx)yyxyxxyx = xxyyyx(xy)yyxyxxyx
xxyyyx(yx)yyyxxxxy = xxyyyx(xy)yyyxxxxy
xxyyyx(yx)yyyxxxyx = xxyyyx(xy)yyyxxxyx
xxyyyxyyxx(yx)xyxy = xxyyyxyyxx(xy)xyxy
xxyyyxyyxx(yx)xyyx = xxyyyxyyxx(xy)xyyx
xxyyyxyyxx(yx)yxxy = xxyyyxyyxx(xy)yxxy
xxyyyxyyx(yx)xyyxx = xxyyyxyyx(xy)xyyxx
xxyyyxyyx(yx)yxxxy = xxyyyxyyx(xy)yxxxy
xxyyyxyyx(yx)yxxyx = xxyyyxyyx(xy)yxxyx
xxyyyx(yyx)yyxxxxy = xxyyyx(xyy)yyxxxxy
xxyyyxy(yx)yyxxxxy = xxyyyxy(xy)yyxxxxy
xxyyyx(yyx)yyxxxyx = xxyyyx(xyy)yyxxxyx
xxyyyxy(yx)yyxxxyx = xxyyyxy(xy)yyxxxyx
xxyyyxy(yx)yyxxyxx = xxyyyxy(xy)yyxxyxx
xxyyyxyyyxx(yx)xyx = xxyyyxyyyxx(xy)xyx
xxyyyyxxx(yx)xyxyy = xxyyyyxxx(xy)xyxyy
xxyyyyxxx(yx)xyyxy = xxyyyyxxx(xy)xyyxy
xxyyyyxxx(yx)xyyyx = xxyyyyxxx(xy)xyyyx
xxyyyyxxx(yx)yxxyy = xxyyyyxxx(xy)yxxyy
xxyyyyxxxy(yx)xyyx = xxyyyyxxxy(xy)xyyx
xxyyyyxxxy(yx)yxxy = xxyyyyxxxy(xy)yxxy
xxyyyyxx(yxx)xyyxy = xxyyyyxx(xxy)xyyxy
xxyyyyxx(yx)xxyyxy = xxyyyyxx(xy)xxyyxy
xxyyyyxx(yxx)xyyyx = xxyyyyxx(xxy)xyyyx
xxyyyyxx(yx)xxyyyx = xxyyyyxx(xy)xxyyyx
xxyyyyxx(yxx)yxxyy = xxyyyyxx(xxy)yxxyy
xxyyyyxx(yx)xyxxyy = xxyyyyxx(xy)xyxxyy
xxyyyyxx(yx)xyxyxy = xxyyyyxx(xy)xyxyxy
xxyyyyxx(yx)xyxyyx = xxyyyyxx(xy)xyxyyx
xxyyyyxx(yxxy)xyyx = xxyyyyxx(xyyx)xyyx
xxyyyyxx(yx)xyyxxy = xxyyyyxx(xy)xyyxxy
xxyyyyxx(yxxy)yxxy = xxyyyyxx(xyyx)yxxy
xxyyyyxx(yx)xyyxyx = xxyyyyxx(xy)xyyxyx
xxyyyyxx(yx)xyyyxx = xxyyyyxx(xy)xyyyxx
xxyyyyxx(yx)yxxxyy = xxyyyyxx(xy)yxxxyy
xxyyyyxx(yx)yxxyxy = xxyyyyxx(xy)yxxyxy
xxyyyyxx(yxyx)xyyx = xxyyyyxx(xyxy)xyyx
xxyyyyxx(yx)yxxyyx = xxyyyyxx(xy)yxxyyx
xxyyyyxxyx(yx)xyyx = xxyyyyxxyx(xy)xyyx
xxyyyyxx(yxyx)yxxy = xxyyyyxx(xyxy)yxxy
xxyyyyxx(yx)yxyxxy = xxyyyyxx(xy)yxyxxy
xxyyyyxxyx(yx)yxxy = xxyyyyxxyx(xy)yxxy
xxyyyyxx(yx)yyxxxy = xxyyyyxx(xy)yyxxxy
xxyyyyxxy(yx)xyyxx = xxyyyyxxy(xy)xyyxx
xxyyyyxx(yyx)yxxxy = xxyyyyxx(xyy)yxxxy
xxyyyyxxy(yx)yxxxy = xxyyyyxxy(xy)yxxxy
xxyyyyxxy(yx)yxxyx = xxyyyyxxy(xy)yxxyx
xxyyyyx(yxx)xyyyxx = xxyyyyx(xxy)xyyyxx
xxyyyyx(yx)xxyyyxx = xxyyyyx(xy)xxyyyxx
xxyyyyxyxx(yx)xyxy = xxyyyyxyxx(xy)xyxy
xxyyyyxyxx(yx)xyyx = xxyyyyxyxx(xy)xyyx
xxyyyyxyxx(yx)yxxy = xxyyyyxyxx(xy)yxxy
xxyyyyx(yx)xyxyyxx = xxyyyyx(xy)xyxyyxx
xxyyyyx(yxxy)xyyxx = xxyyyyx(xyyx)xyyxx
xxyyyyx(yxx)yyxxxy = xxyyyyx(xxy)yyxxxy
xxyyyyx(yx)xyyxxxy = xxyyyyx(xy)xyyxxxy
xxyyyyx(yxxy)yxxxy = xxyyyyx(xyyx)yxxxy
xxyyyyx(yx)xyyxxyx = xxyyyyx(xy)xyyxxyx
xxyyyyx(yxxy)yxxyx = xxyyyyx(xyyx)yxxyx
xxyyyyx(yx)xyyxyxx = xxyyyyx(xy)xyyxyxx
xxyyyyx(yx)xyyyxxx = xxyyyyx(xy)xyyyxxx
xxyyyyx(yx)yxxxxyy = xxyyyyx(xy)yxxxxyy
xxyyyyx(yx)yxxxyxy = xxyyyyx(xy)yxxxyxy
xxyyyyx(yx)yxxxyyx = xxyyyyx(xy)yxxxyyx
xxyyyyx(yx)yxxyxxy = xxyyyyx(xy)yxxyxxy
xxyyyyx(yx)yxxyxyx = xxyyyyx(xy)yxxyxyx
xxyyyyx(yxyx)xyyxx = xxyyyyx(xyxy)xyyxx
xxyyyyx(yx)yxxyyxx = xxyyyyx(xy)yxxyyxx
xxyyyyxyx(yx)xyyxx = xxyyyyxyx(xy)xyyxx
xxyyyyx(yxyx)yxxxy = xxyyyyx(xxyy)yxxxy
xxyyyyx(yxyx)yxxxy = xxyyyyx(xyxy)yxxxy
xxyyyyx(yx)yxyxxxy = xxyyyyx(xy)yxyxxxy
xxyyyyxyx(yx)yxxxy = xxyyyyxyx(xy)yxxxy
xxyyyyx(yxyx)yxxyx = xxyyyyx(xyxy)yxxyx
xxyyyyx(yx)yxyxxyx = xxyyyyx(xy)yxyxxyx
xxyyyyxyx(yx)yxxyx = xxyyyyxyx(xy)yxxyx
xxyyyyx(yx)yxyxyxx = xxyyyyx(xy)yxyxyxx
xxyyyyx(yx)yxyyxxx = xxyyyyx(xy)yxyyxxx
xxyyyyx(yx)yyxxxxy = xxyyyyx(xy)yyxxxxy
xxyyyyx(yx)yyxxxyx = xxyyyyx(xy)yyxxxyx
xxyyyyx(yx)yyxxyxx = xxyyyyx(xy)yyxxyxx
xxyyyyxyyxx(yx)xyx = xxyyyyxyyxx(xy)xyx
xxyyyyyxxx(yx)xyxy = xxyyyyyxxx(xy)xyxy
xxyyyyyxxx(yx)xyyx = xxyyyyyxxx(xy)xyyx
xxyyyyyxxx(yx)yxxy = xxyyyyyxxx(xy)yxxy
xxyyyyyxx(yxx)xyyx = xxyyyyyxx(xxy)xyyx
xxyyyyyxx(yx)xxyyx = xxyyyyyxx(xy)xxyyx
xxyyyyyxx(yxx)yxxy = xxyyyyyxx(xxy)yxxy
xxyyyyyxx(yx)xyxxy = xxyyyyyxx(xy)xyxxy
xxyyyyyxx(yx)xyxyx = xxyyyyyxx(xy)xyxyx
xxyyyyyxx(yx)xyyxx = xxyyyyyxx(xy)xyyxx
xxyyyyyxx(yx)yxxxy = xxyyyyyxx(xy)yxxxy
xxyyyyyxx(yx)yxxyx = xxyyyyyxx(xy)yxxyx
xxyyyyyxyxx(yx)xyx = xxyyyyyxyxx(xy)xyx
xxyyyyyx(yx)xyyxxx = xxyyyyyx(xy)xyyxxx
xxyyyyyx(yx)yxxxxy = xxyyyyyx(xy)yxxxxy
xxyyyyyx(yx)yxxxyx = xxyyyyyx(xy)yxxxyx
xxyyyyyx(yx)yxxyxx = xxyyyyyx(xy)yxxyxx
xxyyyyyx(yx)yxyxxx = xxyyyyyx(xy)yxyxxx
xxyyyyyyxxx(yx)xyx = xxyyyyyyxxx(xy)xyx
xxyyyyyyxx(yx)xyxx = xxyyyyyyxx(xy)xyxx
xyxxxxxyy(yx)yxyyy = xyxxxxxyy(xy)yxyyy
xyxxxxxyyy(yx)yxyy = xyxxxxxyyy(xy)yxyy
xyxxxxxyyy(yx)yyxy = xyxxxxxyyy(xy)yyxy
xyxxxxxyyy(yyx)yxy = xyxxxxxyyy(xyy)yxy
xyxxxxxyyyy(yx)yxy = xyxxxxxyyyy(xy)yxy
xyxxxxyxyy(yx)yxyy = xyxxxxyxyy(xy)yxyy
xyxxxxyxyyy(yx)yxy = xyxxxxyxyyy(xy)yxy
xyxxxxy(yx)xyxyyyy = xyxxxxy(xy)xyxyyyy
xyxxxxy(yx)xyyxyyy = xyxxxxy(xy)xyyxyyy
xyxxxxy(yx)xyyyxyy = xyxxxxy(xy)xyyyxyy
xyxxxxy(yx)xyyyyxy = xyxxxxy(xy)xyyyyxy
xyxxxxy(yx)xyyyyyx = xyxxxxy(xy)xyyyyyx
xyxxxxy(yx)yxxyyyy = xyxxxxy(xy)yxxyyyy
xyxxxxyyxyy(yx)yxy = xyxxxxyyxyy(xy)yxy
xyxxxxyy(yx)xyyxyy = xyxxxxyy(xy)xyyxyy
xyxxxxyy(yx)xyyyxy = xyxxxxyy(xy)xyyyxy
xyxxxxyy(yx)xyyyyx = xyxxxxyy(xy)xyyyyx
xyxxxxyy(yx)yxxyyy = xyxxxxyy(xy)yxxyyy
xyxxxxyy(yx)yxyxyy = xyxxxxyy(xy)yxyxyy
xyxxxxyy(yx)yxyyxy = xyxxxxyy(xy)yxyyxy
xyxxxxyy(yxyxy)yxy = xyxxxxyy(xyyyx)yxy
xyxxxxyy(yx)yxyyyx = xyxxxxyy(xy)yxyyyx
xyxxxxyy(yx)yyxxyy = xyxxxxyy(xy)yyxxyy
xyxxxxyy(yxyyx)yxy = xyxxxxyy(xyyxy)yxy
xyxxxxyy(yx)yyxyxy = xyxxxxyy(xy)yyxyxy
xyxxxxyyyxy(yx)yxy = xyxxxxyyyxy(xy)yxy
xyxxxxyy(yx)yyyxxy = xyxxxxyy(xy)yyyxxy
xyxxxxyy(yyx)xyyxy = xyxxxxyy(xyy)xyyxy
xyxxxxyy(yyxxy)yxy = xyxxxxyy(xyyyx)yxy
xyxxxxyyy(yx)xyyxy = xyxxxxyyy(xy)xyyxy
xyxxxxyyy(yxxy)yxy = xyxxxxyyy(xyyx)yxy
xyxxxxyy(yyx)xyyyx = xyxxxxyy(xyy)xyyyx
xyxxxxyyy(yx)xyyyx = xyxxxxyyy(xy)xyyyx
xyxxxxyy(yyx)yxxyy = xyxxxxyy(xyy)yxxyy
xyxxxxyyy(yx)yxxyy = xyxxxxyyy(xy)yxxyy
xyxxxxyy(yyxyx)yxy = xyxxxxyy(xyyxy)yxy
xyxxxxyy(yyx)yxyxy = xyxxxxyy(xyy)yxyxy
xyxxxxyyy(yxyx)yxy = xyxxxxyyy(xyxy)yxy
xyxxxxyyy(yx)yxyxy = xyxxxxyyy(xy)yxyxy
xyxxxxyyyyx(yx)yxy = xyxxxxyyyyx(xy)yxy
xyxxxxyyy(yx)yxyyx = xyxxxxyyy(xy)yxyyx
xyxxxxyy(yyx)yyxxy = xyxxxxyy(xyy)yyxxy
xyxxxxyyy(yx)yyxxy = xyxxxxyyy(xy)yyxxy
xyxxxxyyy(yx)yyxyx = xyxxxxyyy(xy)yyxyx
xyxxxyxxyy(yx)yxyy = xyxxxyxxyy(xy)yxyy
xyxxxyxxyyy(yx)yxy = xyxxxyxxyyy(xy)yxy
xyxxxyxyxyy(yx)yxy = xyxxxyxyxyy(xy)yxy
xyxxxyxy(yx)xyyxyy = xyxxxyxy(xy)xyyxyy
xyxxxyxy(yx)xyyyxy = xyxxxyxy(xy)xyyyxy
xyxxxyxy(yx)xyyyyx = xyxxxyxy(xy)xyyyyx
xyxxxyxy(yx)yxxyyy = xyxxxyxy(xy)yxxyyy
xyxxxyxyy(yx)xyyxy = xyxxxyxyy(xy)xyyxy
xyxxxyxyy(yx)xyyyx = xyxxxyxyy(xy)xyyyx
xyxxxyxyy(yx)yxxyy = xyxxxyxyy(xy)yxxyy
xyxxxyxyy(yx)yxyxy = xyxxxyxyy(xy)yxyxy
xyxxxyxyy(yx)yxyyx = xyxxxyxyy(xy)yxyyx
xyxxxyxyy(yx)yyxxy = xyxxxyxyy(xy)yyxxy
xyxxxy(yx)xxyyxyyy = xyxxxy(xy)xxyyxyyy
xyxxxy(yx)xxyyyxyy = xyxxxy(xy)xxyyyxyy
xyxxxy(yx)xxyyyyxy = xyxxxy(xy)xxyyyyxy
xyxxxy(yx)xxyyyyyx = xyxxxy(xy)xxyyyyyx
xyxxxy(yx)xyxyxyyy = xyxxxy(xy)xyxyxyyy
xyxxxy(yx)xyxyyxyy = xyxxxy(xy)xyxyyxyy
xyxxxy(yxxy)xyyxyy = xyxxxy(xyyx)xyyxyy
xyxxxy(yx)xyxyyyxy = xyxxxy(xy)xyxyyyxy
xyxxxy(yxxy)xyyyxy = xyxxxy(xyyx)xyyyxy
xyxxxy(yx)xyxyyyyx = xyxxxy(xy)xyxyyyyx
xyxxxy(yxxy)xyyyyx = xyxxxy(xyyx)xyyyyx
xyxxxy(yx)xyyxxyyy = xyxxxy(xy)xyyxxyyy
xyxxxy(yxxy)yxxyyy = xyxxxy(xyyx)yxxyyy
xyxxxy(yx)xyyxyxyy = xyxxxy(xy)xyyxyxyy
xyxxxy(yx)xyyxyyxy = xyxxxy(xy)xyyxyyxy
xyxxxy(yxxyyxy)yxy = xyxxxy(xyxyyyx)yxy
xyxxxy(yx)xyyxyyyx = xyxxxy(xy)xyyxyyyx
xyxxxy(yx)xyyyxxyy = xyxxxy(xy)xyyyxxyy
xyxxxy(yxxyyyx)yxy = xyxxxy(xyxyyxy)yxy
xyxxxy(yx)xyyyxyxy = xyxxxy(xy)xyyyxyxy
xyxxxyyxxyy(yx)yxy = xyxxxyyxxyy(xy)yxy
xyxxxy(yx)xyyyxyyx = xyxxxy(xy)xyyyxyyx
xyxxxy(yx)xyyyyxxy = xyxxxy(xy)xyyyyxxy
xyxxxy(yx)xyyyyxyx = xyxxxy(xy)xyyyyxyx
xyxxxy(yx)xyyyyyxx = xyxxxy(xy)xyyyyyxx
xyxxxy(yx)yxxxyyyy = xyxxxy(xy)yxxxyyyy
xyxxxy(yx)yxxyxyyy = xyxxxy(xy)yxxyxyyy
xyxxxy(yxyx)xyyxyy = xyxxxy(xyxy)xyyxyy
xyxxxy(yx)yxxyyxyy = xyxxxy(xy)yxxyyxyy
xyxxxyyx(yx)xyyxyy = xyxxxyyx(xy)xyyxyy
xyxxxy(yxyx)xyyyxy = xyxxxy(xyxy)xyyyxy
xyxxxy(yx)yxxyyyxy = xyxxxy(xy)yxxyyyxy
xyxxxyyx(yx)xyyyxy = xyxxxyyx(xy)xyyyxy
xyxxxy(yxyx)xyyyyx = xyxxxy(xyxy)xyyyyx
xyxxxy(yx)yxxyyyyx = xyxxxy(xy)yxxyyyyx
xyxxxyyx(yx)xyyyyx = xyxxxyyx(xy)xyyyyx
xyxxxy(yxyx)yxxyyy = xyxxxy(xyxy)yxxyyy
xyxxxy(yx)yxyxxyyy = xyxxxy(xy)yxyxxyyy
xyxxxyyx(yx)yxxyyy = xyxxxyyx(xy)yxxyyy
xyxxxy(yx)yyxxxyyy = xyxxxy(xy)yyxxxyyy
xyxxxyyxy(yx)xyyxy = xyxxxyyxy(xy)xyyxy
xyxxxyyxy(yx)xyyyx = xyxxxyyxy(xy)xyyyx
xyxxxyyxy(yx)yxxyy = xyxxxyyxy(xy)yxxyy
xyxxxyyxy(yx)yxyxy = xyxxxyyxy(xy)yxyxy
xyxxxyyxy(yx)yyxxy = xyxxxyyxy(xy)yyxxy
xyxxxy(yyxx)xyyyxy = xyxxxy(xyxy)xyyyxy
xyxxxy(yyx)xxyyyxy = xyxxxy(xyy)xxyyyxy
xyxxxyy(yxx)xyyyxy = xyxxxyy(xxy)xyyyxy
xyxxxyy(yx)xxyyyxy = xyxxxyy(xy)xxyyyxy
xyxxxy(yyxx)xyyyyx = xyxxxy(xyxy)xyyyyx
xyxxxy(yyx)xxyyyyx = xyxxxy(xyy)xxyyyyx
xyxxxyy(yxx)xyyyyx = xyxxxyy(xxy)xyyyyx
xyxxxyy(yx)xxyyyyx = xyxxxyy(xy)xxyyyyx
xyxxxyy(yx)xyxyyxy = xyxxxyy(xy)xyxyyxy
xyxxxyy(yxxy)xyyxy = xyxxxyy(xyyx)xyyxy
xyxxxyy(yx)xyxyyyx = xyxxxyy(xy)xyxyyyx
xyxxxyy(yxxy)xyyyx = xyxxxyy(xyyx)xyyyx
xyxxxyy(yx)xyyxxyy = xyxxxyy(xy)xyyxxyy
xyxxxyy(yxxy)yxxyy = xyxxxyy(xyyx)yxxyy
xyxxxyy(yx)xyyxyxy = xyxxxyy(xy)xyyxyxy
xyxxxyy(yxxy)yxyxy = xyxxxyy(xyyx)yxyxy
xyxxxyy(yx)xyyxyyx = xyxxxyy(xy)xyyxyyx
xyxxxyy(yx)xyyyxxy = xyxxxyy(xy)xyyyxxy
xyxxxyy(yxxy)yyxxy = xyxxxyy(xyyx)yyxxy
xyxxxyy(yx)xyyyxyx = xyxxxyy(xy)xyyyxyx
xyxxxyy(yx)xyyyyxx = xyxxxyy(xy)xyyyyxx
xyxxxy(yyx)yxxxyyy = xyxxxy(xyy)yxxxyyy
xyxxxyy(yx)yxxxyyy = xyxxxyy(xy)yxxxyyy
xyxxxyy(yx)yxxyxyy = xyxxxyy(xy)yxxyxyy
xyxxxyy(yxyx)xyyxy = xyxxxyy(xyxy)xyyxy
xyxxxyy(yx)yxxyyxy = xyxxxyy(xy)yxxyyxy
xyxxxyyyx(yx)xyyxy = xyxxxyyyx(xy)xyyxy
xyxxxyy(yxyx)xyyyx = xyxxxyy(xyxy)xyyyx
xyxxxyy(yx)yxxyyyx = xyxxxyy(xy)yxxyyyx
xyxxxyyyx(yx)xyyyx = xyxxxyyyx(xy)xyyyx
xyxxxyy(yxyx)yxxyy = xyxxxyy(xyxy)yxxyy
xyxxxyy(yx)yxyxxyy = xyxxxyy(xy)yxyxxyy
xyxxxyyyx(yx)yxxyy = xyxxxyyyx(xy)yxxyy
xyxxxyy(yxyx)yxyxy = xyxxxyy(xyxy)yxyxy
xyxxxyy(yx)yxyxyxy = xyxxxyy(xy)yxyxyxy
xyxxxyyyx(yx)yxyxy = xyxxxyyyx(xy)yxyxy
xyxxxyy(yx)yxyxyyx = xyxxxyy(xy)yxyxyyx
xyxxxyy(yxyx)yyxxy = xyxxxyy(xyxy)yyxxy
xyxxxyy(yx)yxyyxxy = xyxxxyy(xy)yxyyxxy
xyxxxyyyx(yx)yyxxy = xyxxxyyyx(xy)yyxxy
xyxxxyy(yx)yxyyxyx = xyxxxyy(xy)yxyyxyx
xyxxxyy(yx)yxyyyxx = xyxxxyy(xy)yxyyyxx
xyxxxyy(yx)yyxxxyy = xyxxxyy(xy)yyxxxyy
xyxxxyy(yx)yyxxyxy = xyxxxyy(xy)yyxxyxy
xyxxxyy(yx)yyxxyyx = xyxxxyy(xy)yyxxyyx
xyxxxyy(yx)yyxyxxy = xyxxxyy(xy)yyxyxxy
xyxxxyy(yx)yyxyxyx = xyxxxyy(xy)yyxyxyx
xyxxxyy(yx)yyyxxxy = xyxxxyy(xy)yyyxxxy
xyxxxyy(yx)yyyxxyx = xyxxxyy(xy)yyyxxyx
xyxxxyy(yyx)xyyyxx = xyxxxyy(xyy)xyyyxx
xyxxxyyy(yx)xyyyxx = xyxxxyyy(xy)xyyyxx
xyxxxyyyyx(yx)xyyx = xyxxxyyyyx(xy)xyyx
xyxxxyyyyx(yx)yxxy = xyxxxyyyyx(xy)yxxy
xyxxxyyyyx(yx)yxyx = xyxxxyyyyx(xy)yxyx
xyxxxyyy(yx)yxyyxx = xyxxxyyy(xy)yxyyxx
xyxxxyy(yyx)yyxxxy = xyxxxyy(xyy)yyxxxy
xyxxxyyy(yx)yyxxxy = xyxxxyyy(xy)yyxxxy
xyxxxyy(yyx)yyxxyx = xyxxxyy(xyy)yyxxyx
xyxxxyyy(yx)yyxxyx = xyxxxyyy(xy)yyxxyx
xyxxxyyy(yx)yyxyxx = xyxxxyyy(xy)yyxyxx
xyxx(yx)xxxyyxyyyy = xyxx(xy)xxxyyxyyyy
xyxx(yx)xxxyyyxyyy = xyxx(xy)xxxyyyxyyy
xyxx(yx)xxxyyyyxyy = xyxx(xy)xxxyyyyxyy
xyxx(yx)xxxyyyyyxy = xyxx(xy)xxxyyyyyxy
xyxx(yx)xxxyyyyyyx = xyxx(xy)xxxyyyyyyx
xyxxyxxxyy(yx)yxyy = xyxxyxxxyy(xy)yxyy
xyxxyxxxyyy(yx)yxy = xyxxyxxxyyy(xy)yxy
xyxxyxxyxyy(yx)yxy = xyxxyxxyxyy(xy)yxy
xyxxyxxy(yx)xyyxyy = xyxxyxxy(xy)xyyxyy
xyxxyxxy(yx)xyyyxy = xyxxyxxy(xy)xyyyxy
xyxxyxxy(yx)xyyyyx = xyxxyxxy(xy)xyyyyx
xyxxyxxy(yx)yxxyyy = xyxxyxxy(xy)yxxyyy
xyxxyxxyy(yx)xyyxy = xyxxyxxyy(xy)xyyxy
xyxxyxxyy(yx)xyyyx = xyxxyxxyy(xy)xyyyx
xyxxyxxyy(yx)yxxyy = xyxxyxxyy(xy)yxxyy
xyxxyxxyy(yx)yxyxy = xyxxyxxyy(xy)yxyxy
xyxxyxxyy(yx)yxyyx = xyxxyxxyy(xy)yxyyx
xyxxyxxyy(yx)yyxxy = xyxxyxxyy(xy)yyxxy
xyxxyx(yx)xxyyxyyy = xyxxyx(xy)xxyyxyyy
xyxxyx(yx)xxyyyxyy = xyxxyx(xy)xxyyyxyy
xyxxyx(yx)xxyyyyxy = xyxxyx(xy)xxyyyyxy
xyxxyx(yx)xxyyyyyx = xyxxyx(xy)xxyyyyyx
xyxxyxyxxyy(yx)yxy = xyxxyxyxxyy(xy)yxy
xyxxyxyxy(yx)xyyxy = xyxxyxyxy(xy)xyyxy
xyxxyxyxy(yx)xyyyx = xyxxyxyxy(xy)xyyyx
xyxxyxyxy(yx)yxxyy = xyxxyxyxy(xy)yxxyy
xyxxyxy(yx)xxyyyxy = xyxxyxy(xy)xxyyyxy
xyxxyxy(yx)xxyyyyx = xyxxyxy(xy)xxyyyyx
xyxxyxy(yx)xyxyyxy = xyxxyxy(xy)xyxyyxy
xyxxyxy(yxxy)xyyxy = xyxxyxy(xyyx)xyyxy
xyxxyxy(yx)xyxyyyx = xyxxyxy(xy)xyxyyyx
xyxxyxy(yxxy)xyyyx = xyxxyxy(xyyx)xyyyx
xyxxyxy(yx)xyyxxyy = xyxxyxy(xy)xyyxxyy
xyxxyxy(yxxy)yxxyy = xyxxyxy(xyyx)yxxyy
xyxxyxy(yx)xyyxyxy = xyxxyxy(xy)xyyxyxy
xyxxyxy(yx)xyyxyyx = xyxxyxy(xy)xyyxyyx
xyxxyxy(yx)xyyyxxy = xyxxyxy(xy)xyyyxxy
xyxxyxy(yx)xyyyxyx = xyxxyxy(xy)xyyyxyx
xyxxyxy(yx)xyyyyxx = xyxxyxy(xy)xyyyyxx
xyxxyxy(yx)yxxxyyy = xyxxyxy(xy)yxxxyyy
xyxxyxy(yx)yxxyxyy = xyxxyxy(xy)yxxyxyy
xyxxyxy(yxyx)xyyxy = xyxxyxy(xyxy)xyyxy
xyxxyxy(yx)yxxyyxy = xyxxyxy(xy)yxxyyxy
xyxxyxyyx(yx)xyyxy = xyxxyxyyx(xy)xyyxy
xyxxyxy(yxyx)xyyyx = xyxxyxy(xyxy)xyyyx
xyxxyxy(yx)yxxyyyx = xyxxyxy(xy)yxxyyyx
xyxxyxyyx(yx)xyyyx = xyxxyxyyx(xy)xyyyx
xyxxyxy(yxyx)yxxyy = xyxxyxy(xyxy)yxxyy
xyxxyxy(yx)yxyxxyy = xyxxyxy(xy)yxyxxyy
xyxxyxyyx(yx)yxxyy = xyxxyxyyx(xy)yxxyy
xyxxyxy(yx)yyxxxyy = xyxxyxy(xy)yyxxxyy
xyxxyxyy(yx)xyyyxx = xyxxyxyy(xy)xyyyxx
xyxxyxyyyx(yx)xyyx = xyxxyxyyyx(xy)xyyx
xyxxyxyyyx(yx)yxxy = xyxxyxyyyx(xy)yxxy
xyxxyxyy(yx)yxyyxx = xyxxyxyy(xy)yxyyxx
xyxxyxyy(yx)yyxxxy = xyxxyxyy(xy)yyxxxy
xyxxyxyy(yx)yyxxyx = xyxxyxyy(xy)yyxxyx
xyxxy(yxx)xxyyyyxy = xyxxy(xxy)xxyyyyxy
xyxxy(yx)xxxyyyyxy = xyxxy(xy)xxxyyyyxy
xyxxy(yxx)xxyyyyyx = xyxxy(xxy)xxyyyyyx
xyxxy(yx)xxxyyyyyx = xyxxy(xy)xxxyyyyyx
xyxxy(yx)xxyxyyyxy = xyxxy(xy)xxyxyyyxy
xyxxy(yx)xxyxyyyyx = xyxxy(xy)xxyxyyyyx
xyxxy(yx)xxyyxyyxy = xyxxy(xy)xxyyxyyxy
xyxxy(yxxxyyxy)yxy = xyxxy(xyxxyyyx)yxy
xyxxy(yx)xxyyxyyyx = xyxxy(xy)xxyyxyyyx
xyxxy(yx)xxyyyxxyy = xyxxy(xy)xxyyyxxyy
xyxxy(yxxxyyyx)yxy = xyxxy(xyxxyyxy)yxy
xyxxy(yx)xxyyyxyxy = xyxxy(xy)xxyyyxyxy
xyxxyyxxxyy(yx)yxy = xyxxyyxxxyy(xy)yxy
xyxxy(yx)xxyyyxyyx = xyxxy(xy)xxyyyxyyx
xyxxy(yx)xxyyyyxxy = xyxxy(xy)xxyyyyxxy
xyxxy(yx)xxyyyyxyx = xyxxy(xy)xxyyyyxyx
xyxxy(yx)xxyyyyyxx = xyxxy(xy)xxyyyyyxx
xyxxy(yx)xyxxyyyxy = xyxxy(xy)xyxxyyyxy
xyxxy(yxxy)xxyyyxy = xyxxy(xyyx)xxyyyxy
xyxxy(yx)xyxxyyyyx = xyxxy(xy)xyxxyyyyx
xyxxy(yxxy)xxyyyyx = xyxxy(xyyx)xxyyyyx
xyxxy(yx)xyxyxyyxy = xyxxy(xy)xyxyxyyxy
xyxxy(yxxyxy)xyyxy = xyxxy(xyxyyx)xyyxy
xyxxy(yxxy)xyxyyxy = xyxxy(xyyx)xyxyyxy
xyxxy(yxxyxy)xyyxy = xyxxy(xyyxyx)xyyxy
xyxxy(yx)xyxyxyyyx = xyxxy(xy)xyxyxyyyx
xyxxy(yxxyxy)xyyyx = xyxxy(xyxyyx)xyyyx
xyxxy(yxxy)xyxyyyx = xyxxy(xyyx)xyxyyyx
xyxxy(yxxyxy)xyyyx = xyxxy(xyyxyx)xyyyx
xyxxy(yx)xyxyyxxyy = xyxxy(xy)xyxyyxxyy
xyxxy(yxxyxy)yxxyy = xyxxy(xyxyyx)yxxyy
xyxxy(yxxy)xyyxxyy = xyxxy(xyyx)xyyxxyy
xyxxy(yxxyxy)yxxyy = xyxxy(xyyxyx)yxxyy
xyxxy(yx)xyxyyxyxy = xyxxy(xy)xyxyyxyxy
xyxxy(yxxy)xyyxyxy = xyxxy(xyyx)xyyxyxy
xyxxy(yx)xyxyyxyyx = xyxxy(xy)xyxyyxyyx
xyxxy(yxxy)xyyxyyx = xyxxy(xyyx)xyyxyyx
xyxxy(yx)xyxyyyxxy = xyxxy(xy)xyxyyyxxy
xyxxy(yxxy)xyyyxxy = xyxxy(xyyx)xyyyxxy
xyxxy(yx)xyxyyyxyx = xyxxy(xy)xyxyyyxyx
xyxxy(yxxy)xyyyxyx = xyxxy(xyyx)xyyyxyx
xyxxy(yx)xyxyyyyxx = xyxxy(xy)xyxyyyyxx
xyxxy(yxxy)xyyyyxx = xyxxy(xyyx)xyyyyxx
xyxxy(yx)xyyxxxyyy = xyxxy(xy)xyyxxxyyy
xyxxy(yxxy)yxxxyyy = xyxxy(xyyx)yxxxyyy
xyxxy(yx)xyyxxyxyy = xyxxy(xy)xyyxxyxyy
xyxxy(yxxy)yxxyxyy = xyxxy(xyyx)yxxyxyy
xyxxy(yxxyyx)xyyxy = xyxxy(xyxyxy)xyyxy
xyxxy(yx)xyyxxyyxy = xyxxy(xy)xyyxxyyxy
xyxxy(yxxyyx)xyyxy = xyxxy(xyyxxy)xyyxy
xyxxy(yxxy)yxxyyxy = xyxxy(xyyx)yxxyyxy
xyxxyyxxy(yx)xyyxy = xyxxyyxxy(xy)xyyxy
xyxxy(yxxyyx)xyyyx = xyxxy(xyxyxy)xyyyx
xyxxy(yx)xyyxxyyyx = xyxxy(xy)xyyxxyyyx
xyxxy(yxxyyx)xyyyx = xyxxy(xyyxxy)xyyyx
xyxxy(yxxy)yxxyyyx = xyxxy(xyyx)yxxyyyx
xyxxyyxxy(yx)xyyyx = xyxxyyxxy(xy)xyyyx
xyxxy(yxxyyx)yxxyy = xyxxy(xyxyxy)yxxyy
xyxxy(yx)xyyxyxxyy = xyxxy(xy)xyyxyxxyy
xyxxy(yxxyyx)yxxyy = xyxxy(xyyxxy)yxxyy
xyxxy(yxxy)yxyxxyy = xyxxy(xyyx)yxyxxyy
xyxxyyxxy(yx)yxxyy = xyxxyyxxy(xy)yxxyy
xyxxy(yx)xyyxyxyxy = xyxxy(xy)xyyxyxyxy
xyxxy(yx)xyyxyxyyx = xyxxy(xy)xyyxyxyyx
xyxxy(yx)xyyxyyxxy = xyxxy(xy)xyyxyyxxy
xyxxy(yx)xyyxyyxyx = xyxxy(xy)xyyxyyxyx
xyxxy(yx)xyyxyyyxx = xyxxy(xy)xyyxyyyxx
xyxxy(yx)xyyyxxxyy = xyxxy(xy)xyyyxxxyy
xyxxy(yxxy)yyxxxyy = xyxxy(xyyx)yyxxxyy
xyxxy(yx)xyyyxxyxy = xyxxy(xy)xyyyxxyxy
xyxxy(yx)xyyyxxyyx = xyxxy(xy)xyyyxxyyx
xyxxy(yx)xyyyxyxxy = xyxxy(xy)xyyyxyxxy
xyxxy(yx)xyyyxyxyx = xyxxy(xy)xyyyxyxyx
xyxxy(yx)xyyyxyyxx = xyxxy(xy)xyyyxyyxx
xyxxy(yx)xyyyyxxxy = xyxxy(xy)xyyyyxxxy
xyxxy(yx)xyyyyxxyx = xyxxy(xy)xyyyyxxyx
xyxxy(yx)xyyyyxyxx = xyxxy(xy)xyyyyxyxx
xyxxy(yx)xyyyyyxxx = xyxxy(xy)xyyyyyxxx
xyxxy(yx)yxxxxyyyy = xyxxy(xy)yxxxxyyyy
xyxxy(yx)yxxxyxyyy = xyxxy(xy)yxxxyxyyy
xyxxy(yx)yxxxyyxyy = xyxxy(xy)yxxxyyxyy
xyxxy(yxyx)xxyyyxy = xyxxy(xyxy)xxyyyxy
xyxxy(yx)yxxxyyyxy = xyxxy(xy)yxxxyyyxy
xyxxyyx(yx)xxyyyxy = xyxxyyx(xy)xxyyyxy
xyxxy(yxyx)xxyyyyx = xyxxy(xyxy)xxyyyyx
xyxxy(yx)yxxxyyyyx = xyxxy(xy)yxxxyyyyx
xyxxyyx(yx)xxyyyyx = xyxxyyx(xy)xxyyyyx
xyxxy(yx)yxxyxxyyy = xyxxy(xy)yxxyxxyyy
xyxxy(yx)yxxyxyxyy = xyxxy(xy)yxxyxyxyy
xyxxy(yxyx)xyxyyxy = xyxxy(xyxy)xyxyyxy
xyxxy(yxyxxy)xyyxy = xyxxy(xyxyyx)xyyxy
xyxxy(yx)yxxyxyyxy = xyxxy(xy)yxxyxyyxy
xyxxy(yxyxxy)xyyxy = xyxxy(xyyxyx)xyyxy
xyxxyyx(yx)xyxyyxy = xyxxyyx(xy)xyxyyxy
xyxxyyx(yxxy)xyyxy = xyxxyyx(xyyx)xyyxy
xyxxy(yxyx)xyxyyyx = xyxxy(xyxy)xyxyyyx
xyxxy(yxyxxy)xyyyx = xyxxy(xyxyyx)xyyyx
xyxxy(yx)yxxyxyyyx = xyxxy(xy)yxxyxyyyx
xyxxy(yxyxxy)xyyyx = xyxxy(xyyxyx)xyyyx
xyxxyyx(yx)xyxyyyx = xyxxyyx(xy)xyxyyyx
xyxxyyx(yxxy)xyyyx = xyxxyyx(xyyx)xyyyx
xyxxy(yxyx)xyyxxyy = xyxxy(xyxy)xyyxxyy
xyxxy(yxyxxy)yxxyy = xyxxy(xyxyyx)yxxyy
xyxxy(yx)yxxyyxxyy = xyxxy(xy)yxxyyxxyy
xyxxy(yxyxxy)yxxyy = xyxxy(xyyxyx)yxxyy
xyxxyyx(yx)xyyxxyy = xyxxyyx(xy)xyyxxyy
xyxxyyx(yxxy)yxxyy = xyxxyyx(xyyx)yxxyy
xyxxy(yxyx)xyyxyxy = xyxxy(xyxy)xyyxyxy
xyxxy(yx)yxxyyxyxy = xyxxy(xy)yxxyyxyxy
xyxxyyx(yx)xyyxyxy = xyxxyyx(xy)xyyxyxy
xyxxy(yxyx)xyyxyyx = xyxxy(xyxy)xyyxyyx
xyxxy(yx)yxxyyxyyx = xyxxy(xy)yxxyyxyyx
xyxxyyx(yx)xyyxyyx = xyxxyyx(xy)xyyxyyx
xyxxy(yxyx)xyyyxxy = xyxxy(xyxy)xyyyxxy
xyxxy(yx)yxxyyyxxy = xyxxy(xy)yxxyyyxxy
xyxxyyx(yx)xyyyxxy = xyxxyyx(xy)xyyyxxy
xyxxy(yxyx)xyyyxyx = xyxxy(xyxy)xyyyxyx
xyxxy(yx)yxxyyyxyx = xyxxy(xy)yxxyyyxyx
xyxxyyx(yx)xyyyxyx = xyxxyyx(xy)xyyyxyx
xyxxy(yxyx)xyyyyxx = xyxxy(xyxy)xyyyyxx
xyxxy(yx)yxxyyyyxx = xyxxy(xy)yxxyyyyxx
xyxxyyx(yx)xyyyyxx = xyxxyyx(xy)xyyyyxx
xyxxy(yxyx)yxxxyyy = xyxxy(xyxy)yxxxyyy
xyxxy(yx)yxyxxxyyy = xyxxy(xy)yxyxxxyyy
xyxxyyx(yx)yxxxyyy = xyxxyyx(xy)yxxxyyy
xyxxy(yxyx)yxxyxyy = xyxxy(xyxy)yxxyxyy
xyxxy(yx)yxyxxyxyy = xyxxy(xy)yxyxxyxyy
xyxxyyx(yx)yxxyxyy = xyxxyyx(xy)yxxyxyy
xyxxy(yxyxyx)xyyxy = xyxxy(xyxyxy)xyyxy
xyxxy(yxyx)yxxyyxy = xyxxy(xyxy)yxxyyxy
xyxxy(yxyxyx)xyyxy = xyxxy(xyyxxy)xyyxy
xyxxy(yx)yxyxxyyxy = xyxxy(xy)yxyxxyyxy
xyxxyyx(yxyx)xyyxy = xyxxyyx(xyxy)xyyxy
xyxxyyx(yx)yxxyyxy = xyxxyyx(xy)yxxyyxy
xyxxyyxyx(yx)xyyxy = xyxxyyxyx(xy)xyyxy
xyxxy(yxyxyx)xyyyx = xyxxy(xyxyxy)xyyyx
xyxxy(yxyx)yxxyyyx = xyxxy(xyxy)yxxyyyx
xyxxy(yxyxyx)xyyyx = xyxxy(xyyxxy)xyyyx
xyxxy(yx)yxyxxyyyx = xyxxy(xy)yxyxxyyyx
xyxxyyx(yxyx)xyyyx = xyxxyyx(xyxy)xyyyx
xyxxyyx(yx)yxxyyyx = xyxxyyx(xy)yxxyyyx
xyxxyyxyx(yx)xyyyx = xyxxyyxyx(xy)xyyyx
xyxxy(yxyxyx)yxxyy = xyxxy(xyxyxy)yxxyy
xyxxy(yxyx)yxyxxyy = xyxxy(xyxy)yxyxxyy
xyxxy(yxyxyx)yxxyy = xyxxy(xyyxxy)yxxyy
xyxxy(yx)yxyxyxxyy = xyxxy(xy)yxyxyxxyy
xyxxyyx(yxyx)yxxyy = xyxxyyx(xyxy)yxxyy
xyxxyyx(yx)yxyxxyy = xyxxyyx(xy)yxyxxyy
xyxxyyxyx(yx)yxxyy = xyxxyyxyx(xy)yxxyy
xyxxy(yxyx)yyxxxyy = xyxxy(xyxy)yyxxxyy
xyxxy(yx)yxyyxxxyy = xyxxy(xy)yxyyxxxyy
xyxxyyx(yx)yyxxxyy = xyxxyyx(xy)yyxxxyy
xyxxy(yx)yyxxxxyyy = xyxxy(xy)yyxxxxyyy
xyxxy(yx)yyxxxyxyy = xyxxy(xy)yyxxxyxyy
xyxxy(yx)yyxxxyyxy = xyxxy(xy)yyxxxyyxy
xyxxy(yx)yyxxxyyyx = xyxxy(xy)yyxxxyyyx
xyxxy(yx)yyxxyxxyy = xyxxy(xy)yyxxyxxyy
xyxxyyxy(yx)xyyyxx = xyxxyyxy(xy)xyyyxx
xyxxy(yx)yyxyxxxyy = xyxxy(xy)yyxyxxxyy
xyxxyyxyyx(yx)xyyx = xyxxyyxyyx(xy)xyyx
xyxxyyxyyx(yx)yxxy = xyxxyyxyyx(xy)yxxy
xyxxyyxy(yx)yyxxxy = xyxxyyxy(xy)yyxxxy
xyxxyyxy(yx)yyxxyx = xyxxyyxy(xy)yyxxyx
xyxxy(yx)yyyxxxxyy = xyxxy(xy)yyyxxxxyy
xyxxyyyxx(yx)xyxyy = xyxxyyyxx(xy)xyxyy
xyxxyyyxx(yx)xyyxy = xyxxyyyxx(xy)xyyxy
xyxxyyyxx(yx)xyyyx = xyxxyyyxx(xy)xyyyx
xyxxyyyxx(yx)yxxyy = xyxxyyyxx(xy)yxxyy
xyxxyyyxxy(yx)xyyx = xyxxyyyxxy(xy)xyyx
xyxxyyyxxy(yx)yxxy = xyxxyyyxxy(xy)yxxy
xyxxyy(yx)xyyyxxxy = xyxxyy(xy)xyyyxxxy
xyxxyy(yxxy)yyxxxy = xyxxyy(xyyx)yyxxxy
xyxxyy(yx)xyyyxxyx = xyxxyy(xy)xyyyxxyx
xyxxyy(yxxy)yyxxyx = xyxxyy(xyyx)yyxxyx
xyxxyy(yx)xyyyxyxx = xyxxyy(xy)xyyyxyxx
xyxxyy(yx)xyyyyxxx = xyxxyy(xy)xyyyyxxx
xyxxyyyx(yxx)xyyyx = xyxxyyyx(xxy)xyyyx
xyxxyyyx(yx)xxyyyx = xyxxyyyx(xy)xxyyyx
xyxxyyyx(yx)xyxyyx = xyxxyyyx(xy)xyxyyx
xyxxyyyx(yxxy)xyyx = xyxxyyyx(xyyx)xyyx
xyxxyyyx(yx)xyyxxy = xyxxyyyx(xy)xyyxxy
xyxxyyyx(yxxy)yxxy = xyxxyyyx(xyyx)yxxy
xyxxyyyx(yx)xyyxyx = xyxxyyyx(xy)xyyxyx
xyxxyyyx(yx)xyyyxx = xyxxyyyx(xy)xyyyxx
xyxxyyyx(yx)yxxxyy = xyxxyyyx(xy)yxxxyy
xyxxyyyx(yx)yxxyxy = xyxxyyyx(xy)yxxyxy
xyxxyyyx(yxyx)xyyx = xyxxyyyx(xyxy)xyyx
xyxxyyyx(yx)yxxyyx = xyxxyyyx(xy)yxxyyx
xyxxyyyxyx(yx)xyyx = xyxxyyyxyx(xy)xyyx
xyxxyyyx(yxyx)yxxy = xyxxyyyx(xyxy)yxxy
xyxxyyyx(yx)yxyxxy = xyxxyyyx(xy)yxyxxy
xyxxyyyxyx(yx)yxxy = xyxxyyyxyx(xy)yxxy
xyxxyyyx(yx)yxyxyx = xyxxyyyx(xy)yxyxyx
xyxxyy(yxyx)yyxxxy = xyxxyy(xyxy)yyxxxy
xyxxyy(yx)yxyyxxxy = xyxxyy(xy)yxyyxxxy
xyxxyyyx(yx)yyxxxy = xyxxyyyx(xy)yyxxxy
xyxxyy(yxyx)yyxxyx = xyxxyy(xyxy)yyxxyx
xyxxyy(yx)yxyyxxyx = xyxxyy(xy)yxyyxxyx
xyxxyyyx(yx)yyxxyx = xyxxyyyx(xy)yyxxyx
xyxxyy(yx)yxyyxyxx = xyxxyy(xy)yxyyxyxx
xyxxyy(yx)yxyyyxxx = xyxxyy(xy)yxyyyxxx
xyxxy(yyx)yyxxxxyy = xyxxy(xyy)yyxxxxyy
xyxxyy(yx)yyxxxxyy = xyxxyy(xy)yyxxxxyy
xyxxyy(yx)yyxxxyxy = xyxxyy(xy)yyxxxyxy
xyxxyy(yx)yyxxxyyx = xyxxyy(xy)yyxxxyyx
xyxxyy(yx)yyxxyxxy = xyxxyy(xy)yyxxyxxy
xyxxyy(yx)yyxxyxyx = xyxxyy(xy)yyxxyxyx
xyxxyy(yx)yyxxyyxx = xyxxyy(xy)yyxxyyxx
xyxxyy(yx)yyxyxxxy = xyxxyy(xy)yyxyxxxy
xyxxyy(yx)yyxyxxyx = xyxxyy(xy)yyxyxxyx
xyxxyy(yx)yyxyxyxx = xyxxyy(xy)yyxyxyxx
xyxxyy(yx)yyyxxxxy = xyxxyy(xy)yyyxxxxy
xyxxyy(yx)yyyxxxyx = xyxxyy(xy)yyyxxxyx
xyxxyy(yx)yyyxxyxx = xyxxyy(xy)yyyxxyxx
xyxxyyyyxx(yx)xyxy = xyxxyyyyxx(xy)xyxy
xyxxyyyyxx(yx)xyyx = xyxxyyyyxx(xy)xyyx
xyxxyyyyxx(yx)yxxy = xyxxyyyyxx(xy)yxxy
xyxxyyyyx(yx)xyyxx = xyxxyyyyx(xy)xyyxx
xyxxyyyyx(yx)yxxxy = xyxxyyyyx(xy)yxxxy
xyxxyyyyx(yx)yxxyx = xyxxyyyyx(xy)yxxyx
xyxxyyyyx(yx)yxyxx = xyxxyyyyx(xy)yxyxx
xyxxyy(yyx)yyxxxxy = xyxxyy(xyy)yyxxxxy
xyxxyyy(yx)yyxxxxy = xyxxyyy(xy)yyxxxxy
xyxxyy(yyx)yyxxxyx = xyxxyy(xyy)yyxxxyx
xyxxyyy(yx)yyxxxyx = xyxxyyy(xy)yyxxxyx
xyxxyy(yyx)yyxxyxx = xyxxyy(xyy)yyxxyxx
xyxxyyy(yx)yyxxyxx = xyxxyyy(xy)yyxxyxx
xyxxyyy(yx)yyxyxxx = xyxxyyy(xy)yyxyxxx
xyxxyyyyyxx(yx)xyx = xyxxyyyyyxx(xy)xyx
xyx(yxx)xxxyyyyyxy = xyx(xxy)xxxyyyyyxy
xyx(yx)xxxxyyyyyxy = xyx(xy)xxxxyyyyyxy
xyx(yxx)xxxyyyyyyx = xyx(xxy)xxxyyyyyyx
xyx(yx)xxxxyyyyyyx = xyx(xy)xxxxyyyyyyx
xyx(yx)xxxyxyyyyxy = xyx(xy)xxxyxyyyyxy
xyx(yx)xxxyxyyyyyx = xyx(xy)xxxyxyyyyyx
xyx(yx)xxxyyxyyyxy = xyx(xy)xxxyyxyyyxy
xyx(yx)xxxyyxyyyyx = xyx(xy)xxxyyxyyyyx
xyxyxxxxyy(yx)yxyy = xyxyxxxxyy(xy)yxyy
xyx(yx)xxxyyyxyyxy = xyx(xy)xxxyyyxyyxy
xyx(yxxxxyyyxy)yxy = xyx(xyxxxyyyyx)yxy
xyx(yx)xxxyyyxyyyx = xyx(xy)xxxyyyxyyyx
xyx(yx)xxxyyyyxxyy = xyx(xy)xxxyyyyxxyy
xyx(yxxxxyyyyx)yxy = xyx(xyxxxyyyxy)yxy
xyx(yx)xxxyyyyxyxy = xyx(xy)xxxyyyyxyxy
xyxyxxxxyyy(yx)yxy = xyxyxxxxyyy(xy)yxy
xyx(yx)xxxyyyyxyyx = xyx(xy)xxxyyyyxyyx
xyx(yx)xxxyyyyyxxy = xyx(xy)xxxyyyyyxxy
xyx(yx)xxxyyyyyxyx = xyx(xy)xxxyyyyyxyx
xyx(yx)xxxyyyyyyxx = xyx(xy)xxxyyyyyyxx
xyx(yx)xxyxxyyyyxy = xyx(xy)xxyxxyyyyxy
xyx(yxxxy)xxyyyyxy = xyx(xyxyx)xxyyyyxy
xyx(yxxxy)xxyyyyxy = xyx(xyyxx)xxyyyyxy
xyx(yx)xxyxxyyyyyx = xyx(xy)xxyxxyyyyyx
xyx(yxxxy)xxyyyyyx = xyx(xyxyx)xxyyyyyx
xyx(yxxxy)xxyyyyyx = xyx(xyyxx)xxyyyyyx
xyx(yx)xxyxyxyyyxy = xyx(xy)xxyxyxyyyxy
xyx(yxxxyxy)xyyyxy = xyx(xyxxyyx)xyyyxy
xyx(yx)xxyxyxyyyyx = xyx(xy)xxyxyxyyyyx
xyx(yxxxyxy)xyyyyx = xyx(xyxxyyx)xyyyyx
xyx(yx)xxyxyyxyyxy = xyx(xy)xxyxyyxyyxy
xyx(yxxxyxyyxy)yxy = xyx(xyxxyxyyyx)yxy
xyx(yx)xxyxyyxyyyx = xyx(xy)xxyxyyxyyyx
xyx(yx)xxyxyyyxxyy = xyx(xy)xxyxyyyxxyy
xyx(yxxxyxyyyx)yxy = xyx(xyxxyxyyxy)yxy
xyx(yx)xxyxyyyxyxy = xyx(xy)xxyxyyyxyxy
xyxyxxxyxyy(yx)yxy = xyxyxxxyxyy(xy)yxy
xyx(yx)xxyxyyyxyyx = xyx(xy)xxyxyyyxyyx
xyx(yx)xxyxyyyyxxy = xyx(xy)xxyxyyyyxxy
xyx(yx)xxyxyyyyxyx = xyx(xy)xxyxyyyyxyx
xyx(yx)xxyxyyyyyxx = xyx(xy)xxyxyyyyyxx
xyxyxxxy(yx)xyyxyy = xyxyxxxy(xy)xyyxyy
xyx(yxxxyyx)xyyyxy = xyx(xyxxyxy)xyyyxy
xyx(yx)xxyyxxyyyxy = xyx(xy)xxyyxxyyyxy
xyxyxxxy(yx)xyyyxy = xyxyxxxy(xy)xyyyxy
xyx(yxxxyyx)xyyyyx = xyx(xyxxyxy)xyyyyx
xyx(yx)xxyyxxyyyyx = xyx(xy)xxyyxxyyyyx
xyxyxxxy(yx)xyyyyx = xyxyxxxy(xy)xyyyyx
xyxyxxxy(yx)yxxyyy = xyxyxxxy(xy)yxxyyy
xyx(yx)xxyyxyxyyxy = xyx(xy)xxyyxyxyyxy
xyx(yxxxyyxy)xyyxy = xyx(xyxxyyyx)xyyxy
xyx(yx)xxyyxyxyyyx = xyx(xy)xxyyxyxyyyx
xyx(yxxxyyxy)xyyyx = xyx(xyxxyyyx)xyyyx
xyx(yx)xxyyxyyxxyy = xyx(xy)xxyyxyyxxyy
xyx(yxxxyyxy)yxxyy = xyx(xyxxyyyx)yxxyy
xyx(yx)xxyyxyyxyxy = xyx(xy)xxyyxyyxyxy
xyx(yxxxyyxy)yxyxy = xyx(xyxxyyyx)yxyxy
xyx(yx)xxyyxyyxyyx = xyx(xy)xxyyxyyxyyx
xyx(yxxxyyxy)yxyyx = xyx(xyxxyyyx)yxyyx
xyx(yx)xxyyxyyyxxy = xyx(xy)xxyyxyyyxxy
xyx(yxxxyyxy)yyxxy = xyx(xyxxyyyx)yyxxy
xyx(yx)xxyyxyyyxyx = xyx(xy)xxyyxyyyxyx
xyx(yx)xxyyxyyyyxx = xyx(xy)xxyyxyyyyxx
xyx(yx)xxyyyxxxyyy = xyx(xy)xxyyyxxxyyy
xyx(yx)xxyyyxxyxyy = xyx(xy)xxyyyxxyxyy
xyx(yxxxyyyx)xyyxy = xyx(xyxxyyxy)xyyxy
xyx(yx)xxyyyxxyyxy = xyx(xy)xxyyyxxyyxy
xyxyxxxyy(yx)xyyxy = xyxyxxxyy(xy)xyyxy
xyx(yxxxyyyx)xyyyx = xyx(xyxxyyxy)xyyyx
xyx(yx)xxyyyxxyyyx = xyx(xy)xxyyyxxyyyx
xyxyxxxyy(yx)xyyyx = xyxyxxxyy(xy)xyyyx
xyx(yxxxyyyx)yxxyy = xyx(xyxxyyxy)yxxyy
xyx(yx)xxyyyxyxxyy = xyx(xy)xxyyyxyxxyy
xyxyxxxyy(yx)yxxyy = xyxyxxxyy(xy)yxxyy
xyx(yxxxyyyx)yxyxy = xyx(xyxxyyxy)yxyxy
xyx(yx)xxyyyxyxyxy = xyx(xy)xxyyyxyxyxy
xyxyxxxyy(yx)yxyxy = xyxyxxxyy(xy)yxyxy
xyx(yxxxyyyx)yxyyx = xyx(xyxxyyxy)yxyyx
xyx(yx)xxyyyxyxyyx = xyx(xy)xxyyyxyxyyx
xyxyxxxyy(yx)yxyyx = xyxyxxxyy(xy)yxyyx
xyx(yxxxyyyx)yyxxy = xyx(xyxxyyxy)yyxxy
xyx(yx)xxyyyxyyxxy = xyx(xy)xxyyyxyyxxy
xyxyxxxyy(yx)yyxxy = xyxyxxxyy(xy)yyxxy
xyx(yx)xxyyyxyyxyx = xyx(xy)xxyyyxyyxyx
xyx(yx)xxyyyxyyyxx = xyx(xy)xxyyyxyyyxx
xyx(yx)xxyyyyxxxyy = xyx(xy)xxyyyyxxxyy
xyx(yx)xxyyyyxxyxy = xyx(xy)xxyyyyxxyxy
xyx(yx)xxyyyyxxyyx = xyx(xy)xxyyyyxxyyx
xyx(yx)xxyyyyxyxxy = xyx(xy)xxyyyyxyxxy
xyx(yx)xxyyyyxyxyx = xyx(xy)xxyyyyxyxyx
xyx(yx)xxyyyyxyyxx = xyx(xy)xxyyyyxyyxx
xyx(yx)xxyyyyyxxxy = xyx(xy)xxyyyyyxxxy
xyx(yx)xxyyyyyxxyx = xyx(xy)xxyyyyyxxyx
xyx(yx)xxyyyyyxyxx = xyx(xy)xxyyyyyxyxx
xyx(yx)xxyyyyyyxxx = xyx(xy)xxyyyyyyxxx
xyxyxx(yx)xxyyxyyy = xyxyxx(xy)xxyyxyyy
xyxyxx(yx)xxyyyxyy = xyxyxx(xy)xxyyyxyy
xyx(yxxyx)xxyyyyxy = xyx(xyxxy)xxyyyyxy
xyx(yx)xyxxxyyyyxy = xyx(xy)xyxxxyyyyxy
xyx(yxxy)xxxyyyyxy = xyx(xyyx)xxxyyyyxy
xyxyxx(yx)xxyyyyxy = xyxyxx(xy)xxyyyyxy
xyx(yxxyx)xxyyyyyx = xyx(xyxxy)xxyyyyyx
xyx(yx)xyxxxyyyyyx = xyx(xy)xyxxxyyyyyx
xyx(yxxy)xxxyyyyyx = xyx(xyyx)xxxyyyyyx
xyxyxx(yx)xxyyyyyx = xyxyxx(xy)xxyyyyyx
xyxyxxyxxyy(yx)yxy = xyxyxxyxxyy(xy)yxy
xyxyxxyxy(yx)xyyxy = xyxyxxyxy(xy)xyyxy
xyxyxxyxy(yx)xyyyx = xyxyxxyxy(xy)xyyyx
xyxyxxyxy(yx)yxxyy = xyxyxxyxy(xy)yxxyy
xyxyxxy(yx)xxyyyxy = xyxyxxy(xy)xxyyyxy
xyxyxxy(yx)xxyyyyx = xyxyxxy(xy)xxyyyyx
xyxyxxy(yx)xyxyyxy = xyxyxxy(xy)xyxyyxy
xyxyxxy(yxxy)xyyxy = xyxyxxy(xyyx)xyyxy
xyxyxxy(yx)xyxyyyx = xyxyxxy(xy)xyxyyyx
xyxyxxy(yxxy)xyyyx = xyxyxxy(xyyx)xyyyx
xyxyxxy(yx)xyyxxyy = xyxyxxy(xy)xyyxxyy
xyxyxxy(yxxy)yxxyy = xyxyxxy(xyyx)yxxyy
xyxyxxy(yx)xyyxyxy = xyxyxxy(xy)xyyxyxy
xyxyxxy(yx)xyyxyyx = xyxyxxy(xy)xyyxyyx
xyxyxxy(yx)xyyyxxy = xyxyxxy(xy)xyyyxxy
xyxyxxy(yx)xyyyxyx = xyxyxxy(xy)xyyyxyx
xyxyxxy(yx)xyyyyxx = xyxyxxy(xy)xyyyyxx
xyxyxxy(yx)yxxxyyy = xyxyxxy(xy)yxxxyyy
xyxyxxy(yx)yxxyxyy = xyxyxxy(xy)yxxyxyy
xyxyxxy(yxyx)xyyxy = xyxyxxy(xyxy)xyyxy
xyxyxxy(yx)yxxyyxy = xyxyxxy(xy)yxxyyxy
xyxyxxyyx(yx)xyyxy = xyxyxxyyx(xy)xyyxy
xyxyxxy(yxyx)xyyyx = xyxyxxy(xyxy)xyyyx
xyxyxxy(yx)yxxyyyx = xyxyxxy(xy)yxxyyyx
xyxyxxyyx(yx)xyyyx = xyxyxxyyx(xy)xyyyx
xyxyxxy(yxyx)yxxyy = xyxyxxy(xyxy)yxxyy
xyxyxxy(yx)yxyxxyy = xyxyxxy(xy)yxyxxyy
xyxyxxyyx(yx)yxxyy = xyxyxxyyx(xy)yxxyy
xyxyxxy(yx)yyxxxyy = xyxyxxy(xy)yyxxxyy
xyxyxxyy(yx)xyyyxx = xyxyxxyy(xy)xyyyxx
xyxyxxyyyx(yx)xyyx = xyxyxxyyyx(xy)xyyx
xyxyxxyyyx(yx)yxxy = xyxyxxyyyx(xy)yxxy
xyxyxxyy(yx)yxyyxx = xyxyxxyy(xy)yxyyxx
xyxyxxyy(yx)yyxxxy = xyxyxxyy(xy)yyxxxy
xyxyxxyy(yx)yyxxyx = xyxyxxyy(xy)yyxxyx
xyx(yx)yxxxxxyyyyy = xyx(xy)yxxxxxyyyyy
xyx(yx)yxxxxyxyyyy = xyx(xy)yxxxxyxyyyy
xyx(yx)yxxxxyyxyyy = xyx(xy)yxxxxyyxyyy
xyx(yx)yxxxxyyyxyy = xyx(xy)yxxxxyyyxyy
xyx(yxyxx)xxyyyyxy = xyx(xyxxy)xxyyyyxy
xyx(yxyx)xxxyyyyxy = xyx(xyxy)xxxyyyyxy
xyx(yx)yxxxxyyyyxy = xyx(xy)yxxxxyyyyxy
xyxyx(yxx)xxyyyyxy = xyxyx(xxy)xxyyyyxy
xyxyx(yx)xxxyyyyxy = xyxyx(xy)xxxyyyyxy
xyx(yxyxx)xxyyyyyx = xyx(xyxxy)xxyyyyyx
xyx(yxyx)xxxyyyyyx = xyx(xyxy)xxxyyyyyx
xyx(yx)yxxxxyyyyyx = xyx(xy)yxxxxyyyyyx
xyxyx(yxx)xxyyyyyx = xyxyx(xxy)xxyyyyyx
xyxyx(yx)xxxyyyyyx = xyxyx(xy)xxxyyyyyx
xyxyx(yx)xxyxyyyxy = xyxyx(xy)xxyxyyyxy
xyxyx(yx)xxyxyyyyx = xyxyx(xy)xxyxyyyyx
xyxyx(yx)xxyyxyyxy = xyxyx(xy)xxyyxyyxy
xyxyx(yxxxyyxy)yxy = xyxyx(xyxxyyyx)yxy
xyxyx(yx)xxyyxyyyx = xyxyx(xy)xxyyxyyyx
xyxyx(yx)xxyyyxxyy = xyxyx(xy)xxyyyxxyy
xyxyx(yxxxyyyx)yxy = xyxyx(xyxxyyxy)yxy
xyxyx(yx)xxyyyxyxy = xyxyx(xy)xxyyyxyxy
xyxyxyxxxyy(yx)yxy = xyxyxyxxxyy(xy)yxy
xyxyx(yx)xxyyyxyyx = xyxyx(xy)xxyyyxyyx
xyxyx(yx)xxyyyyxxy = xyxyx(xy)xxyyyyxxy
xyxyx(yx)xxyyyyxyx = xyxyx(xy)xxyyyyxyx
xyxyx(yx)xxyyyyyxx = xyxyx(xy)xxyyyyyxx
xyxyx(yx)xyxxyyyxy = xyxyx(xy)xyxxyyyxy
xyxyx(yxxy)xxyyyxy = xyxyx(xyyx)xxyyyxy
xyxyx(yx)xyxxyyyyx = xyxyx(xy)xyxxyyyyx
xyxyx(yxxy)xxyyyyx = xyxyx(xyyx)xxyyyyx
xyxyxyxxy(yx)xyyxy = xyxyxyxxy(xy)xyyxy
xyxyxyxxy(yx)xyyyx = xyxyxyxxy(xy)xyyyx
xyxyxyxxy(yx)yxxyy = xyxyxyxxy(xy)yxxyy
xyxyx(yx)yxxxxyyyy = xyxyx(xy)yxxxxyyyy
xyxyx(yx)yxxxyxyyy = xyxyx(xy)yxxxyxyyy
xyxyx(yx)yxxxyyxyy = xyxyx(xy)yxxxyyxyy
xyxyx(yxyx)xxyyyxy = xyxyx(xyxy)xxyyyxy
xyxyx(yx)yxxxyyyxy = xyxyx(xy)yxxxyyyxy
xyxyxyx(yx)xxyyyxy = xyxyxyx(xy)xxyyyxy
xyxyx(yxyx)xxyyyyx = xyxyx(xyxy)xxyyyyx
xyxyx(yx)yxxxyyyyx = xyxyx(xy)yxxxyyyyx
xyxyxyx(yx)xxyyyyx = xyxyxyx(xy)xxyyyyx
xyxyxyx(yx)yxxxyyy = xyxyxyx(xy)yxxxyyy
xyxyxyxy(yx)xyyyxx = xyxyxyxy(xy)xyyyxx
xyxyxyxyyx(yx)xyyx = xyxyxyxyyx(xy)xyyx
xyxyxyxyyx(yx)yxxy = xyxyxyxyyx(xy)yxxy
xyxyxyxy(yx)yyxxxy = xyxyxyxy(xy)yyxxxy
xyxyxyyxxy(yx)xyyx = xyxyxyyxxy(xy)xyyx
xyxyxyyxxy(yx)yxxy = xyxyxyyxxy(xy)yxxy
xyxyxy(yx)xyyyxxxy = xyxyxy(xy)xyyyxxxy
xyxyxy(yxxy)yyxxxy = xyxyxy(xyyx)yyxxxy
xyxyxy(yx)xyyyxxyx = xyxyxy(xy)xyyyxxyx
xyxyxy(yx)xyyyxyxx = xyxyxy(xy)xyyyxyxx
xyxyxy(yx)xyyyyxxx = xyxyxy(xy)xyyyyxxx
xyxyxyyx(yx)xxyyyx = xyxyxyyx(xy)xxyyyx
xyxyxyyx(yx)xyxyyx = xyxyxyyx(xy)xyxyyx
xyxyxyyx(yxxy)xyyx = xyxyxyyx(xyyx)xyyx
xyxyxyyx(yx)xyyxxy = xyxyxyyx(xy)xyyxxy
xyxyxyyx(yxxy)yxxy = xyxyxyyx(xyyx)yxxy
xyxyxyyx(yx)xyyxyx = xyxyxyyx(xy)xyyxyx
xyxyxyyx(yx)xyyyxx = xyxyxyyx(xy)xyyyxx
xyxyxyyx(yx)yxxxyy = xyxyxyyx(xy)yxxxyy
xyxyxyyx(yx)yxxyxy = xyxyxyyx(xy)yxxyxy
xyxyxyyx(yxyx)xyyx = xyxyxyyx(xyxy)xyyx
xyxyxyyx(yx)yxxyyx = xyxyxyyx(xy)yxxyyx
xyxyxyyxyx(yx)xyyx = xyxyxyyxyx(xy)xyyx
xyxyxyyx(yxyx)yxxy = xyxyxyyx(xyxy)yxxy
xyxyxyyx(yx)yxyxxy = xyxyxyyx(xy)yxyxxy
xyxyxyyxyx(yx)yxxy = xyxyxyyxyx(xy)yxxy
xyxyxy(yxyx)yyxxxy = xyxyxy(xyxy)yyxxxy
xyxyxy(yx)yxyyxxxy = xyxyxy(xy)yxyyxxxy
xyxyxyyx(yx)yyxxxy = xyxyxyyx(xy)yyxxxy
xyxyxy(yx)yyxxxxyy = xyxyxy(xy)yyxxxxyy
xyxyxy(yx)yyxxxyxy = xyxyxy(xy)yyxxxyxy
xyxyxy(yx)yyxxxyyx = xyxyxy(xy)yyxxxyyx
xyxyxy(yx)yyxxyxxy = xyxyxy(xy)yyxxyxxy
xyxyxy(yx)yyxyxxxy = xyxyxy(xy)yyxyxxxy
xyxyxy(yx)yyyxxxxy = xyxyxy(xy)yyyxxxxy
xyxyxyyyxx(yx)xyxy = xyxyxyyyxx(xy)xyxy
xyxyxyyyxx(yx)xyyx = xyxyxyyyxx(xy)xyyx
xyxyxyyyxx(yx)yxxy = xyxyxyyyxx(xy)yxxy
xyxyxyyyx(yx)xyyxx = xyxyxyyyx(xy)xyyxx
xyxyxyyyx(yx)yxxxy = xyxyxyyyx(xy)yxxxy
xyxyxyyyx(yx)yxxyx = xyxyxyyyx(xy)yxxyx
xyxyxy(yyx)yyxxxxy = xyxyxy(xyy)yyxxxxy
xyxyxyy(yx)yyxxxxy = xyxyxyy(xy)yyxxxxy
xyxyxyy(yx)yyxxxyx = xyxyxyy(xy)yyxxxyx
xyxyxyy(yx)yyxxyxx = xyxyxyy(xy)yyxxyxx
xyxyxyyyyxx(yx)xyx = xyxyxyyyyxx(xy)xyx
xyxyyxxxxyy(yx)yxy = xyxyyxxxxyy(xy)yxy
xyxyyxxxy(yx)xyyxy = xyxyyxxxy(xy)xyyxy
xyxyyxxxy(yx)xyyyx = xyxyyxxxy(xy)xyyyx
xyxyyxxxy(yx)yxxyy = xyxyyxxxy(xy)yxxyy
xyxyyxxxyy(yx)xyyx = xyxyyxxxyy(xy)xyyx
xyxyyxxxyy(yx)yxxy = xyxyyxxxyy(xy)yxxy
xyxyyxxxyy(yx)yxyx = xyxyyxxxyy(xy)yxyx
xyxyyxx(yx)xxyyxyy = xyxyyxx(xy)xxyyxyy
xyxyyxx(yx)xxyyyxy = xyxyyxx(xy)xxyyyxy
xyxyyxx(yx)xxyyyyx = xyxyyxx(xy)xxyyyyx
xyxyyxx(yx)xyxxyyy = xyxyyxx(xy)xyxxyyy
xyxyyxx(yx)yxxxyyy = xyxyyxx(xy)yxxxyyy
xyxyyxxyxy(yx)xyyx = xyxyyxxyxy(xy)xyyx
xyxyyxxyxy(yx)yxxy = xyxyyxxyxy(xy)yxxy
xyxyyxxy(yx)xxyyyx = xyxyyxxy(xy)xxyyyx
xyxyyxxy(yx)xyxyyx = xyxyyxxy(xy)xyxyyx
xyxyyxxy(yxxy)xyyx = xyxyyxxy(xyyx)xyyx
xyxyyxxy(yx)xyyxxy = xyxyyxxy(xy)xyyxxy
xyxyyxxy(yxxy)yxxy = xyxyyxxy(xyyx)yxxy
xyxyyxxy(yx)xyyxyx = xyxyyxxy(xy)xyyxyx
xyxyyxxy(yx)xyyyxx = xyxyyxxy(xy)xyyyxx
xyxyyxxy(yx)yxxxyy = xyxyyxxy(xy)yxxxyy
xyxyyxxy(yx)yxxyxy = xyxyyxxy(xy)yxxyxy
xyxyyxxy(yxyx)xyyx = xyxyyxxy(xyxy)xyyx
xyxyyxxy(yx)yxxyyx = xyxyyxxy(xy)yxxyyx
xyxyyxxyyx(yx)xyyx = xyxyyxxyyx(xy)xyyx
xyxyyxxy(yxyx)yxxy = xyxyyxxy(xyxy)yxxy
xyxyyxxy(yx)yxyxxy = xyxyyxxy(xy)yxyxxy
xyxyyxxyyx(yx)yxxy = xyxyyxxyyx(xy)yxxy
xyxyyxxy(yx)yyxxxy = xyxyyxxy(xy)yyxxxy
xyxy(yx)xyyyyxxxxy = xyxy(xy)xyyyyxxxxy
xyxy(yxxy)yyyxxxxy = xyxy(xyyx)yyyxxxxy
xyxy(yxxyy)yyxxxxy = xyxy(xyyyx)yyxxxxy
xyxy(yx)xyyyyxxxyx = xyxy(xy)xyyyyxxxyx
xyxy(yx)xyyyyxxyxx = xyxy(xy)xyyyyxxyxx
xyxy(yx)xyyyyxyxxx = xyxy(xy)xyyyyxyxxx
xyxy(yx)xyyyyyxxxx = xyxy(xy)xyyyyyxxxx
xyxyyx(yxx)xxyyyyx = xyxyyx(xxy)xxyyyyx
xyxyyx(yx)xxxyyyyx = xyxyyx(xy)xxxyyyyx
xyxyyx(yx)xxyxyyyx = xyxyyx(xy)xxyxyyyx
xyxyyx(yx)xxyyxyyx = xyxyyx(xy)xxyyxyyx
xyxyyx(yx)xxyyyxxy = xyxyyx(xy)xxyyyxxy
xyxyyx(yx)xxyyyxyx = xyxyyx(xy)xxyyyxyx
xyxyyx(yx)xxyyyyxx = xyxyyx(xy)xxyyyyxx
xyxyyx(yx)xyxxyyyx = xyxyyx(xy)xyxxyyyx
xyxyyx(yxxy)xxyyyx = xyxyyx(xyyx)xxyyyx
xyxyyx(yx)xyxyxyyx = xyxyyx(xy)xyxyxyyx
xyxyyx(yxxyxy)xyyx = xyxyyx(xyxyyx)xyyx
xyxyyx(yxxy)xyxyyx = xyxyyx(xyyx)xyxyyx
xyxyyx(yxxyxy)xyyx = xyxyyx(xyyxyx)xyyx
xyxyyx(yx)xyxyyxxy = xyxyyx(xy)xyxyyxxy
xyxyyx(yxxyxy)yxxy = xyxyyx(xyxyyx)yxxy
xyxyyx(yxxy)xyyxxy = xyxyyx(xyyx)xyyxxy
xyxyyx(yxxyxy)yxxy = xyxyyx(xyyxyx)yxxy
xyxyyx(yx)xyxyyxyx = xyxyyx(xy)xyxyyxyx
xyxyyx(yxxy)xyyxyx = xyxyyx(xyyx)xyyxyx
xyxyyx(yx)xyxyyyxx = xyxyyx(xy)xyxyyyxx
xyxyyx(yxxy)xyyyxx = xyxyyx(xyyx)xyyyxx
xyxyyx(yx)xyyxxxyy = xyxyyx(xy)xyyxxxyy
xyxyyx(yxxy)yxxxyy = xyxyyx(xyyx)yxxxyy
xyxyyx(yx)xyyxxyxy = xyxyyx(xy)xyyxxyxy
xyxyyx(yxxy)yxxyxy = xyxyyx(xyyx)yxxyxy
xyxyyx(yxxyyx)xyyx = xyxyyx(xyxyxy)xyyx
xyxyyx(yx)xyyxxyyx = xyxyyx(xy)xyyxxyyx
xyxyyx(yxxyyx)xyyx = xyxyyx(xyyxxy)xyyx
xyxyyx(yxxy)yxxyyx = xyxyyx(xyyx)yxxyyx
xyxyyxyxxy(yx)xyyx = xyxyyxyxxy(xy)xyyx
xyxyyx(yxxyyx)yxxy = xyxyyx(xyxyxy)yxxy
xyxyyx(yx)xyyxyxxy = xyxyyx(xy)xyyxyxxy
xyxyyx(yxxyyx)yxxy = xyxyyx(xyyxxy)yxxy
xyxyyx(yxxy)yxyxxy = xyxyyx(xyyx)yxyxxy
xyxyyxyxxy(yx)yxxy = xyxyyxyxxy(xy)yxxy
xyxyyx(yx)xyyxyxyx = xyxyyx(xy)xyyxyxyx
xyxyyx(yx)xyyxyyxx = xyxyyx(xy)xyyxyyxx
xyxyyx(yx)xyyyxxxy = xyxyyx(xy)xyyyxxxy
xyxyyx(yxxy)yyxxxy = xyxyyx(xyyx)yyxxxy
xyxyyx(yx)xyyyxxyx = xyxyyx(xy)xyyyxxyx
xyxyyx(yx)xyyyxyxx = xyxyyx(xy)xyyyxyxx
xyxyyx(yx)xyyyyxxx = xyxyyx(xy)xyyyyxxx
xyxyyx(yx)yxxxxyyy = xyxyyx(xy)yxxxxyyy
xyxyyx(yx)yxxxyxyy = xyxyyx(xy)yxxxyxyy
xyxyyx(yx)yxxxyyxy = xyxyyx(xy)yxxxyyxy
xyxyyx(yxyx)xxyyyx = xyxyyx(xyxy)xxyyyx
xyxyyx(yx)yxxxyyyx = xyxyyx(xy)yxxxyyyx
xyxyyxyx(yx)xxyyyx = xyxyyxyx(xy)xxyyyx
xyxyyx(yx)yxxyxxyy = xyxyyx(xy)yxxyxxyy
xyxyyx(yx)yxxyxyxy = xyxyyx(xy)yxxyxyxy
xyxyyx(yxyx)xyxyyx = xyxyyx(xyxy)xyxyyx
xyxyyx(yxyxxy)xyyx = xyxyyx(xyxyyx)xyyx
xyxyyx(yx)yxxyxyyx = xyxyyx(xy)yxxyxyyx
xyxyyx(yxyxxy)xyyx = xyxyyx(xyyxyx)xyyx
xyxyyxyx(yx)xyxyyx = xyxyyxyx(xy)xyxyyx
xyxyyxyx(yxxy)xyyx = xyxyyxyx(xyyx)xyyx
xyxyyx(yxyx)xyyxxy = xyxyyx(xyxy)xyyxxy
xyxyyx(yxyxxy)yxxy = xyxyyx(xyxyyx)yxxy
xyxyyx(yx)yxxyyxxy = xyxyyx(xy)yxxyyxxy
xyxyyx(yxyxxy)yxxy = xyxyyx(xyyxyx)yxxy
xyxyyxyx(yx)xyyxxy = xyxyyxyx(xy)xyyxxy
xyxyyxyx(yxxy)yxxy = xyxyyxyx(xyyx)yxxy
xyxyyx(yxyx)xyyxyx = xyxyyx(xyxy)xyyxyx
xyxyyx(yx)yxxyyxyx = xyxyyx(xy)yxxyyxyx
xyxyyxyx(yx)xyyxyx = xyxyyxyx(xy)xyyxyx
xyxyyx(yxyx)xyyyxx = xyxyyx(xyxy)xyyyxx
xyxyyx(yx)yxxyyyxx = xyxyyx(xy)yxxyyyxx
xyxyyxyx(yx)xyyyxx = xyxyyxyx(xy)xyyyxx
xyxyyx(yxyx)yxxxyy = xyxyyx(xyxy)yxxxyy
xyxyyx(yx)yxyxxxyy = xyxyyx(xy)yxyxxxyy
xyxyyxyx(yx)yxxxyy = xyxyyxyx(xy)yxxxyy
xyxyyx(yxyx)yxxyxy = xyxyyx(xyxy)yxxyxy
xyxyyx(yx)yxyxxyxy = xyxyyx(xy)yxyxxyxy
xyxyyxyx(yx)yxxyxy = xyxyyxyx(xy)yxxyxy
xyxyyx(yxyxyx)xyyx = xyxyyx(xyxyxy)xyyx
xyxyyx(yxyx)yxxyyx = xyxyyx(xyxy)yxxyyx
xyxyyx(yxyxyx)xyyx = xyxyyx(xyyxxy)xyyx
xyxyyx(yx)yxyxxyyx = xyxyyx(xy)yxyxxyyx
xyxyyxyx(yxyx)xyyx = xyxyyxyx(xyxy)xyyx
xyxyyxyx(yx)yxxyyx = xyxyyxyx(xy)yxxyyx
xyxyyxyxyx(yx)xyyx = xyxyyxyxyx(xy)xyyx
xyxyyx(yxyxyx)yxxy = xyxyyx(xyxyxy)yxxy
xyxyyx(yxyx)yxyxxy = xyxyyx(xyxy)yxyxxy
xyxyyx(yxyxyx)yxxy = xyxyyx(xyyxxy)yxxy
xyxyyx(yx)yxyxyxxy = xyxyyx(xy)yxyxyxxy
xyxyyxyx(yxyx)yxxy = xyxyyxyx(xyxy)yxxy
xyxyyxyx(yx)yxyxxy = xyxyyxyx(xy)yxyxxy
xyxyyxyxyx(yx)yxxy = xyxyyxyxyx(xy)yxxy
xyxyyx(yxyx)yyxxxy = xyxyyx(xyxy)yyxxxy
xyxyyx(yx)yxyyxxxy = xyxyyx(xy)yxyyxxxy
xyxyyxyx(yx)yyxxxy = xyxyyxyx(xy)yyxxxy
xyxyyx(yx)yyxxxxyy = xyxyyx(xy)yyxxxxyy
xyxyyx(yx)yyxxxyxy = xyxyyx(xy)yyxxxyxy
xyxyyx(yx)yyxxxyyx = xyxyyx(xy)yyxxxyyx
xyxyyx(yx)yyxxyxxy = xyxyyx(xy)yyxxyxxy
xyxyyx(yx)yyxyxxxy = xyxyyx(xy)yyxyxxxy
xyxy(yxyx)yyyxxxxy = xyxy(xyxy)yyyxxxxy
xyxy(yx)yxyyyxxxxy = xyxy(xy)yxyyyxxxxy
xyxy(yxyxy)yyxxxxy = xyxy(xyyyx)yyxxxxy
xyxyyx(yx)yyyxxxxy = xyxyyx(xy)yyyxxxxy
xyxy(yx)yyxxxxxyyy = xyxy(xy)yyxxxxxyyy
xyxy(yx)yyxxxxyxyy = xyxy(xy)yyxxxxyxyy
xyxy(yx)yyxxxxyyxy = xyxy(xy)yyxxxxyyxy
xyxy(yx)yyxxxxyyyx = xyxy(xy)yyxxxxyyyx
xyxy(yx)yyxxxyxxyy = xyxy(xy)yyxxxyxxyy
xyxy(yx)yyxxxyxyxy = xyxy(xy)yyxxxyxyxy
xyxy(yxyyxxxy)xyxy = xyxy(xyyyxxyx)xyxy
xyxy(yx)yyxxxyxyyx = xyxy(xy)yyxxxyxyyx
xyxy(yxyyxxxy)xyyx = xyxy(xyyyxxyx)xyyx
xyxy(yx)yyxxxyyxxy = xyxy(xy)yyxxxyyxxy
xyxy(yxyyxxxy)yxxy = xyxy(xyyyxxyx)yxxy
xyxy(yx)yyxxxyyxyx = xyxy(xy)yyxxxyyxyx
xyxy(yx)yyxxxyyyxx = xyxy(xy)yyxxxyyyxx
xyxy(yx)yyxxyxxxyy = xyxy(xy)yyxxyxxxyy
xyxy(yxyyxxyx)xyxy = xyxy(xyyyxxxy)xyxy
xyxy(yx)yyxxyxxyxy = xyxy(xy)yyxxyxxyxy
xyxyyxyyxx(yx)xyxy = xyxyyxyyxx(xy)xyxy
xyxy(yxyyxxyx)xyyx = xyxy(xyyyxxxy)xyyx
xyxy(yx)yyxxyxxyyx = xyxy(xy)yyxxyxxyyx
xyxyyxyyxx(yx)xyyx = xyxyyxyyxx(xy)xyyx
xyxy(yxyyxxyx)yxxy = xyxy(xyyyxxxy)yxxy
xyxy(yx)yyxxyxyxxy = xyxy(xy)yyxxyxyxxy
xyxyyxyyxx(yx)yxxy = xyxyyxyyxx(xy)yxxy
xyxy(yx)yyxxyyxxxy = xyxy(xy)yyxxyyxxxy
xyxy(yxyyxxy)yxxxy = xyxy(xyyyxyx)yxxxy
xyxy(yx)yyxyxxxxyy = xyxy(xy)yyxyxxxxyy
xyxy(yx)yyxyxxxyxy = xyxy(xy)yyxyxxxyxy
xyxy(yx)yyxyxxxyyx = xyxy(xy)yyxyxxxyyx
xyxy(yx)yyxyxxyxxy = xyxy(xy)yyxyxxyxxy
xyxyyxyyx(yx)xyyxx = xyxyyxyyx(xy)xyyxx
xyxy(yxyyxyx)yxxxy = xyxy(xyyyxxy)yxxxy
xyxy(yx)yyxyxyxxxy = xyxy(xy)yyxyxyxxxy
xyxyyxyyx(yx)yxxxy = xyxyyxyyx(xy)yxxxy
xyxyyxyyx(yx)yxxyx = xyxyyxyyx(xy)yxxyx
xyxy(yxyyx)yyxxxxy = xyxy(xyxyy)yyxxxxy
xyxy(yxyyx)yyxxxxy = xyxy(xyyxy)yyxxxxy
xyxy(yx)yyxyyxxxxy = xyxy(xy)yyxyyxxxxy
xyxyyx(yyx)yyxxxxy = xyxyyx(xyy)yyxxxxy
xyxyyxy(yx)yyxxxxy = xyxyyxy(xy)yyxxxxy
xyxyyxy(yx)yyxxxyx = xyxyyxy(xy)yyxxxyx
xyxyyxy(yx)yyxxyxx = xyxyyxy(xy)yyxxyxx
xyxy(yx)yyyxxxxxyy = xyxy(xy)yyyxxxxxyy
xyxy(yx)yyyxxxxyxy = xyxy(xy)yyyxxxxyxy
xyxy(yx)yyyxxxxyyx = xyxy(xy)yyyxxxxyyx
xyxy(yx)yyyxxxyxxy = xyxy(xy)yyyxxxyxxy
xyxy(yx)yyyxxyxxxy = xyxy(xy)yyyxxyxxxy
xyxyyxyyyxx(yx)xyx = xyxyyxyyyxx(xy)xyx
xyxy(yx)yyyxyxxxxy = xyxy(xy)yyyxyxxxxy
xyxy(yx)yyyyxxxxxy = xyxy(xy)yyyyxxxxxy
xyxyyyxxxy(yx)xyyx = xyxyyyxxxy(xy)xyyx
xyxyyyxxxy(yx)yxxy = xyxyyyxxxy(xy)yxxy
xyxyyyxx(yx)xxyyxy = xyxyyyxx(xy)xxyyxy
xyxyyyxx(yx)xxyyyx = xyxyyyxx(xy)xxyyyx
xyxyyyxx(yx)xyxxyy = xyxyyyxx(xy)xyxxyy
xyxyyyxx(yx)xyxyxy = xyxyyyxx(xy)xyxyxy
xyxyyyxx(yx)xyxyyx = xyxyyyxx(xy)xyxyyx
xyxyyyxx(yxxy)xyyx = xyxyyyxx(xyyx)xyyx
xyxyyyxx(yx)xyyxxy = xyxyyyxx(xy)xyyxxy
xyxyyyxx(yxxy)yxxy = xyxyyyxx(xyyx)yxxy
xyxyyyxx(yx)xyyxyx = xyxyyyxx(xy)xyyxyx
xyxyyyxx(yx)xyyyxx = xyxyyyxx(xy)xyyyxx
xyxyyyxx(yx)yxxxyy = xyxyyyxx(xy)yxxxyy
xyxyyyxx(yx)yxxyxy = xyxyyyxx(xy)yxxyxy
xyxyyyxx(yxyx)xyyx = xyxyyyxx(xyxy)xyyx
xyxyyyxx(yx)yxxyyx = xyxyyyxx(xy)yxxyyx
xyxyyyxxyx(yx)xyyx = xyxyyyxxyx(xy)xyyx
xyxyyyxx(yxyx)yxxy = xyxyyyxx(xyxy)yxxy
xyxyyyxx(yx)yxyxxy = xyxyyyxx(xy)yxyxxy
xyxyyyxxyx(yx)yxxy = xyxyyyxxyx(xy)yxxy
xyxyyyxx(yx)yyxxxy = xyxyyyxx(xy)yyxxxy
xyxyyyxxy(yx)xyyxx = xyxyyyxxy(xy)xyyxx
xyxyyyxx(yyx)yxxxy = xyxyyyxx(xyy)yxxxy
xyxyyyxxy(yx)yxxxy = xyxyyyxxy(xy)yxxxy
xyxyyyxxy(yx)yxxyx = xyxyyyxxy(xy)yxxyx
xyxyyyx(yxx)xyyyxx = xyxyyyx(xxy)xyyyxx
xyxyyyx(yx)xxyyyxx = xyxyyyx(xy)xxyyyxx
xyxyyyxyxx(yx)xyxy = xyxyyyxyxx(xy)xyxy
xyxyyyxyxx(yx)xyyx = xyxyyyxyxx(xy)xyyx
xyxyyyxyxx(yx)yxxy = xyxyyyxyxx(xy)yxxy
xyxyyyx(yx)xyxyyxx = xyxyyyx(xy)xyxyyxx
xyxyyyx(yxxy)xyyxx = xyxyyyx(xyyx)xyyxx
xyxyyyx(yxx)yyxxxy = xyxyyyx(xxy)yyxxxy
xyxyyyx(yx)xyyxxxy = xyxyyyx(xy)xyyxxxy
xyxyyyx(yxxy)yxxxy = xyxyyyx(xyyx)yxxxy
xyxyyyx(yx)xyyxxyx = xyxyyyx(xy)xyyxxyx
xyxyyyx(yxxy)yxxyx = xyxyyyx(xyyx)yxxyx
xyxyyyx(yx)xyyxyxx = xyxyyyx(xy)xyyxyxx
xyxyyyx(yx)xyyyxxx = xyxyyyx(xy)xyyyxxx
xyxyyyx(yx)yxxxxyy = xyxyyyx(xy)yxxxxyy
xyxyyyx(yx)yxxxyxy = xyxyyyx(xy)yxxxyxy
xyxyyyx(yx)yxxxyyx = xyxyyyx(xy)yxxxyyx
xyxyyyx(yx)yxxyxxy = xyxyyyx(xy)yxxyxxy
xyxyyyx(yx)yxxyxyx = xyxyyyx(xy)yxxyxyx
xyxyyyx(yxyx)xyyxx = xyxyyyx(xyxy)xyyxx
xyxyyyx(yx)yxxyyxx = xyxyyyx(xy)yxxyyxx
xyxyyyxyx(yx)xyyxx = xyxyyyxyx(xy)xyyxx
xyxyyyx(yxyx)yxxxy = xyxyyyx(xxyy)yxxxy
xyxyyyx(yxyx)yxxxy = xyxyyyx(xyxy)yxxxy
xyxyyyx(yx)yxyxxxy = xyxyyyx(xy)yxyxxxy
xyxyyyxyx(yx)yxxxy = xyxyyyxyx(xy)yxxxy
xyxyyyx(yxyx)yxxyx = xyxyyyx(xyxy)yxxyx
xyxyyyx(yx)yxyxxyx = xyxyyyx(xy)yxyxxyx
xyxyyyxyx(yx)yxxyx = xyxyyyxyx(xy)yxxyx
xyxyyyx(yx)yxyxyxx = xyxyyyx(xy)yxyxyxx
xyxyyyx(yx)yyxxxxy = xyxyyyx(xy)yyxxxxy
xyxyyyx(yx)yyxxxyx = xyxyyyx(xy)yyxxxyx
xyxyyyx(yx)yyxxyxx = xyxyyyx(xy)yyxxyxx
xyxyyyxyyxx(yx)xyx = xyxyyyxyyxx(xy)xyx
xyxy(yyx)yyyxxxxxy = xyxy(xyy)yyyxxxxxy
xyxyy(yx)yyyxxxxxy = xyxyy(xy)yyyxxxxxy
xyxyy(yx)yyyxxxxyx = xyxyy(xy)yyyxxxxyx
xyxyy(yx)yyyxxxyxx = xyxyy(xy)yyyxxxyxx
xyxyy(yx)yyyxxyxxx = xyxyy(xy)yyyxxyxxx
xyxyyyyxxx(yx)xyxy = xyxyyyyxxx(xy)xyxy
xyxyyyyxxx(yx)xyyx = xyxyyyyxxx(xy)xyyx
xyxyyyyxxx(yx)yxxy = xyxyyyyxxx(xy)yxxy
xyxyyyyxx(yxx)xyyx = xyxyyyyxx(xxy)xyyx
xyxyyyyxx(yx)xxyyx = xyxyyyyxx(xy)xxyyx
xyxyyyyxx(yxx)yxxy = xyxyyyyxx(xxy)yxxy
xyxyyyyxx(yx)xyxxy = xyxyyyyxx(xy)xyxxy
xyxyyyyxx(yx)xyxyx = xyxyyyyxx(xy)xyxyx
xyxyyyyxx(yx)xyyxx = xyxyyyyxx(xy)xyyxx
xyxyyyyxx(yx)yxxxy = xyxyyyyxx(xy)yxxxy
xyxyyyyxx(yx)yxxyx = xyxyyyyxx(xy)yxxyx
xyxyyyyxyxx(yx)xyx = xyxyyyyxyxx(xy)xyx
xyxyyyyx(yx)xyyxxx = xyxyyyyx(xy)xyyxxx
xyxyyyyx(yx)yxxxxy = xyxyyyyx(xy)yxxxxy
xyxyyyyx(yx)yxxxyx = xyxyyyyx(xy)yxxxyx
xyxyyyyx(yx)yxxyxx = xyxyyyyx(xy)yxxyxx
xyxyyyyx(yx)yxyxxx = xyxyyyyx(xy)yxyxxx
xyxyyyyyxxx(yx)xyx = xyxyyyyyxxx(xy)xyx
xyxyyyyyxx(yx)xyxx = xyxyyyyyxx(xy)xyxx
xyyxxxxxyy(yx)yxyy = xyyxxxxxyy(xy)yxyy
xyyxxxxxyyy(yx)yxy = xyyxxxxxyyy(xy)yxy
xyyxxxxyxyy(yx)yxy = xyyxxxxyxyy(xy)yxy
xyyxxxxy(yx)xyxyyy = xyyxxxxy(xy)xyxyyy
xyyxxxxy(yx)xyyxyy = xyyxxxxy(xy)xyyxyy
xyyxxxxy(yx)xyyyxy = xyyxxxxy(xy)xyyyxy
xyyxxxxy(yx)xyyyyx = xyyxxxxy(xy)xyyyyx
xyyxxxxy(yx)yxxyyy = xyyxxxxy(xy)yxxyyy
xyyxxxxyy(yx)xyyxy = xyyxxxxyy(xy)xyyxy
xyyxxxxyy(yx)xyyyx = xyyxxxxyy(xy)xyyyx
xyyxxxxyy(yx)yxxyy = xyyxxxxyy(xy)yxxyy
xyyxxxxyy(yx)yxyxy = xyyxxxxyy(xy)yxyxy
xyyxxxxyy(yx)yxyyx = xyyxxxxyy(xy)yxyyx
xyyxxxxyy(yx)yyxxy = xyyxxxxyy(xy)yyxxy
xyyxxxxyy(yyx)xyyx = xyyxxxxyy(xyy)xyyx
xyyxxxxyyy(yx)xyyx = xyyxxxxyyy(xy)xyyx
xyyxxxxyy(yyx)yxxy = xyyxxxxyy(xyy)yxxy
xyyxxxxyyy(yx)yxxy = xyyxxxxyyy(xy)yxxy
xyyxxxxyyy(yx)yxyx = xyyxxxxyyy(xy)yxyx
xyyxxx(yx)xxyxyyyy = xyyxxx(xy)xxyxyyyy
xyyxxx(yx)xxyyxyyy = xyyxxx(xy)xxyyxyyy
xyyxxx(yx)xxyyyxyy = xyyxxx(xy)xxyyyxyy
xyyxxx(yx)xxyyyyxy = xyyxxx(xy)xxyyyyxy
xyyxxx(yx)xxyyyyyx = xyyxxx(xy)xxyyyyyx
xyyxxxyxxyy(yx)yxy = xyyxxxyxxyy(xy)yxy
xyyxxxyxy(yx)xyyxy = xyyxxxyxy(xy)xyyxy
xyyxxxyxy(yx)xyyyx = xyyxxxyxy(xy)xyyyx
xyyxxxyxy(yx)yxxyy = xyyxxxyxy(xy)yxxyy
xyyxxxyxyy(yx)xyyx = xyyxxxyxyy(xy)xyyx
xyyxxxyxyy(yx)yxxy = xyyxxxyxyy(xy)yxxy
xyyxxxyxyy(yx)yxyx = xyyxxxyxyy(xy)yxyx
xyyxxxy(yx)xxyyxyy = xyyxxxy(xy)xxyyxyy
xyyxxxy(yx)xxyyyxy = xyyxxxy(xy)xxyyyxy
xyyxxxy(yx)xxyyyyx = xyyxxxy(xy)xxyyyyx
xyyxxxy(yx)xyxyxyy = xyyxxxy(xy)xyxyxyy
xyyxxxy(yx)xyxyyxy = xyyxxxy(xy)xyxyyxy
xyyxxxy(yxxy)xyyxy = xyyxxxy(xyyx)xyyxy
xyyxxxy(yx)xyxyyyx = xyyxxxy(xy)xyxyyyx
xyyxxxy(yxxy)xyyyx = xyyxxxy(xyyx)xyyyx
xyyxxxy(yx)xyyxxyy = xyyxxxy(xy)xyyxxyy
xyyxxxy(yxxy)yxxyy = xyyxxxy(xyyx)yxxyy
xyyxxxy(yx)xyyxyxy = xyyxxxy(xy)xyyxyxy
xyyxxxy(yx)xyyxyyx = xyyxxxy(xy)xyyxyyx
xyyxxxy(yx)xyyyxxy = xyyxxxy(xy)xyyyxxy
xyyxxxy(yx)xyyyxyx = xyyxxxy(xy)xyyyxyx
xyyxxxy(yx)xyyyyxx = xyyxxxy(xy)xyyyyxx
xyyxxxy(yx)yxxxyyy = xyyxxxy(xy)yxxxyyy
xyyxxxy(yx)yxxyxyy = xyyxxxy(xy)yxxyxyy
xyyxxxy(yxyx)xyyxy = xyyxxxy(xyxy)xyyxy
xyyxxxy(yx)yxxyyxy = xyyxxxy(xy)yxxyyxy
xyyxxxyyx(yx)xyyxy = xyyxxxyyx(xy)xyyxy
xyyxxxy(yxyx)xyyyx = xyyxxxy(xyxy)xyyyx
xyyxxxy(yx)yxxyyyx = xyyxxxy(xy)yxxyyyx
xyyxxxyyx(yx)xyyyx = xyyxxxyyx(xy)xyyyx
xyyxxxy(yxyx)yxxyy = xyyxxxy(xyxy)yxxyy
xyyxxxy(yx)yxyxxyy = xyyxxxy(xy)yxyxxyy
xyyxxxyyx(yx)yxxyy = xyyxxxyyx(xy)yxxyy
xyyxxxy(yx)yyxxxyy = xyyxxxy(xy)yyxxxyy
xyyxxxyyxy(yx)xyyx = xyyxxxyyxy(xy)xyyx
xyyxxxyyxy(yx)yxxy = xyyxxxyyxy(xy)yxxy
xyyxxxy(yyxx)xyyyx = xyyxxxy(xyxy)xyyyx
xyyxxxy(yyx)xxyyyx = xyyxxxy(xyy)xxyyyx
xyyxxxyy(yxx)xyyyx = xyyxxxyy(xxy)xyyyx
xyyxxxyy(yx)xxyyyx = xyyxxxyy(xy)xxyyyx
xyyxxxyy(yx)xyxyyx = xyyxxxyy(xy)xyxyyx
xyyxxxyy(yxxy)xyyx = xyyxxxyy(xyyx)xyyx
xyyxxxyy(yx)xyyxxy = xyyxxxyy(xy)xyyxxy
xyyxxxyy(yxxy)yxxy = xyyxxxyy(xyyx)yxxy
xyyxxxyy(yx)xyyxyx = xyyxxxyy(xy)xyyxyx
xyyxxxyy(yx)xyyyxx = xyyxxxyy(xy)xyyyxx
xyyxxxy(yyx)yxxxyy = xyyxxxy(xyy)yxxxyy
xyyxxxyy(yx)yxxxyy = xyyxxxyy(xy)yxxxyy
xyyxxxyy(yx)yxxyxy = xyyxxxyy(xy)yxxyxy
xyyxxxyy(yxyx)xyyx = xyyxxxyy(xyxy)xyyx
xyyxxxyy(yx)yxxyyx = xyyxxxyy(xy)yxxyyx
xyyxxxyyyx(yx)xyyx = xyyxxxyyyx(xy)xyyx
xyyxxxyy(yxyx)yxxy = xyyxxxyy(xyxy)yxxy
xyyxxxyy(yx)yxyxxy = xyyxxxyy(xy)yxyxxy
xyyxxxyyyx(yx)yxxy = xyyxxxyyyx(xy)yxxy
xyyxxxyy(yx)yxyxyx = xyyxxxyy(xy)yxyxyx
xyyxxxyy(yx)yxyyxx = xyyxxxyy(xy)yxyyxx
xyyxxxyy(yx)yyxxxy = xyyxxxyy(xy)yyxxxy
xyyxxxyy(yx)yyxxyx = xyyxxxyy(xy)yyxxyx
xyyxx(yxx)xxyyxyyy = xyyxx(xxy)xxyyxyyy
xyyxx(yx)xxxyyxyyy = xyyxx(xy)xxxyyxyyy
xyyxx(yxx)xxyyyxyy = xyyxx(xxy)xxyyyxyy
xyyxx(yx)xxxyyyxyy = xyyxx(xy)xxxyyyxyy
xyyxx(yxx)xxyyyyxy = xyyxx(xxy)xxyyyyxy
xyyxx(yx)xxxyyyyxy = xyyxx(xy)xxxyyyyxy
xyyxx(yxx)xxyyyyyx = xyyxx(xxy)xxyyyyyx
xyyxx(yx)xxxyyyyyx = xyyxx(xy)xxxyyyyyx
xyyxx(yx)xxyxyxyyy = xyyxx(xy)xxyxyxyyy
xyyxx(yx)xxyxyyxyy = xyyxx(xy)xxyxyyxyy
xyyxx(yx)xxyxyyyxy = xyyxx(xy)xxyxyyyxy
xyyxx(yx)xxyxyyyyx = xyyxx(xy)xxyxyyyyx
xyyxx(yx)xxyyxxyyy = xyyxx(xy)xxyyxxyyy
xyyxx(yx)xxyyxyxyy = xyyxx(xy)xxyyxyxyy
xyyxx(yx)xxyyxyyxy = xyyxx(xy)xxyyxyyxy
xyyxx(yxxxyyxy)yxy = xyyxx(xyxxyyyx)yxy
xyyxx(yx)xxyyxyyyx = xyyxx(xy)xxyyxyyyx
xyyxx(yx)xxyyyxxyy = xyyxx(xy)xxyyyxxyy
xyyxx(yxxxyyyx)yxy = xyyxx(xyxxyyxy)yxy
xyyxx(yx)xxyyyxyxy = xyyxx(xy)xxyyyxyxy
xyyxxyxxxyy(yx)yxy = xyyxxyxxxyy(xy)yxy
xyyxx(yx)xxyyyxyyx = xyyxx(xy)xxyyyxyyx
xyyxx(yx)xxyyyyxxy = xyyxx(xy)xxyyyyxxy
xyyxx(yx)xxyyyyxyx = xyyxx(xy)xxyyyyxyx
xyyxx(yx)xxyyyyyxx = xyyxx(xy)xxyyyyyxx
xyyxx(yx)xyxxxyyyy = xyyxx(xy)xyxxxyyyy
xyyxx(yx)xyxxyxyyy = xyyxx(xy)xyxxyxyyy
xyyxx(yx)xyxxyyxyy = xyyxx(xy)xyxxyyxyy
xyyxx(yxxy)xxyyxyy = xyyxx(xyyx)xxyyxyy
xyyxx(yx)xyxxyyyxy = xyyxx(xy)xyxxyyyxy
xyyxx(yxxy)xxyyyxy = xyyxx(xyyx)xxyyyxy
xyyxx(yx)xyxxyyyyx = xyyxx(xy)xyxxyyyyx
xyyxx(yxxy)xxyyyyx = xyyxx(xyyx)xxyyyyx
xyyxxyxxy(yx)xyyxy = xyyxxyxxy(xy)xyyxy
xyyxxyxxy(yx)xyyyx = xyyxxyxxy(xy)xyyyx
xyyxxyxxy(yx)yxxyy = xyyxxyxxy(xy)yxxyy
xyyxxyxxyy(yx)xyyx = xyyxxyxxyy(xy)xyyx
xyyxxyxxyy(yx)yxxy = xyyxxyxxyy(xy)yxxy
xyyxxyxxyy(yx)yxyx = xyyxxyxxyy(xy)yxyx
xyyxx(yx)yxxxxyyyy = xyyxx(xy)yxxxxyyyy
xyyxx(yx)yxxxyxyyy = xyyxx(xy)yxxxyxyyy
xyyxx(yxyx)xxyyxyy = xyyxx(xyxy)xxyyxyy
xyyxx(yx)yxxxyyxyy = xyyxx(xy)yxxxyyxyy
xyyxxyx(yx)xxyyxyy = xyyxxyx(xy)xxyyxyy
xyyxx(yxyx)xxyyyxy = xyyxx(xyxy)xxyyyxy
xyyxx(yx)yxxxyyyxy = xyyxx(xy)yxxxyyyxy
xyyxxyx(yx)xxyyyxy = xyyxxyx(xy)xxyyyxy
xyyxx(yxyx)xxyyyyx = xyyxx(xyxy)xxyyyyx
xyyxx(yx)yxxxyyyyx = xyyxx(xy)yxxxyyyyx
xyyxxyx(yx)xxyyyyx = xyyxxyx(xy)xxyyyyx
xyyxxyx(yx)yxxxyyy = xyyxxyx(xy)yxxxyyy
xyyxxyxyxy(yx)xyyx = xyyxxyxyxy(xy)xyyx
xyyxxyxyxy(yx)yxxy = xyyxxyxyxy(xy)yxxy
xyyxxyxy(yx)xxyyyx = xyyxxyxy(xy)xxyyyx
xyyxxyxy(yx)xyxyyx = xyyxxyxy(xy)xyxyyx
xyyxxyxy(yxxy)xyyx = xyyxxyxy(xyyx)xyyx
xyyxxyxy(yx)xyyxxy = xyyxxyxy(xy)xyyxxy
xyyxxyxy(yxxy)yxxy = xyyxxyxy(xyyx)yxxy
xyyxxyxy(yx)xyyxyx = xyyxxyxy(xy)xyyxyx
xyyxxyxy(yx)xyyyxx = xyyxxyxy(xy)xyyyxx
xyyxxyxy(yx)yxxxyy = xyyxxyxy(xy)yxxxyy
xyyxxyxy(yx)yxxyxy = xyyxxyxy(xy)yxxyxy
xyyxxyxy(yxyx)xyyx = xyyxxyxy(xyxy)xyyx
xyyxxyxy(yx)yxxyyx = xyyxxyxy(xy)yxxyyx
xyyxxyxyyx(yx)xyyx = xyyxxyxyyx(xy)xyyx
xyyxxyxy(yxyx)yxxy = xyyxxyxy(xyxy)yxxy
xyyxxyxy(yx)yxyxxy = xyyxxyxy(xy)yxyxxy
xyyxxyxyyx(yx)yxxy = xyyxxyxyyx(xy)yxxy
xyyxxyxy(yx)yyxxxy = xyyxxyxy(xy)yyxxxy
xyyxx(yyxx)xxyyyyx = xyyxx(xyxy)xxyyyyx
xyyxx(yyx)xxxyyyyx = xyyxx(xyy)xxxyyyyx
xyyxxy(yxx)xxyyyyx = xyyxxy(xxy)xxyyyyx
xyyxxy(yx)xxxyyyyx = xyyxxy(xy)xxxyyyyx
xyyxxy(yx)xxyxyyyx = xyyxxy(xy)xxyxyyyx
xyyxxy(yx)xxyyxyyx = xyyxxy(xy)xxyyxyyx
xyyxxy(yx)xxyyyxxy = xyyxxy(xy)xxyyyxxy
xyyxxy(yx)xxyyyxyx = xyyxxy(xy)xxyyyxyx
xyyxxy(yx)xxyyyyxx = xyyxxy(xy)xxyyyyxx
xyyxxy(yx)xyxxyyyx = xyyxxy(xy)xyxxyyyx
xyyxxy(yxxy)xxyyyx = xyyxxy(xyyx)xxyyyx
xyyxxy(yx)xyxyxyyx = xyyxxy(xy)xyxyxyyx
xyyxxy(yxxyxy)xyyx = xyyxxy(xyxyyx)xyyx
xyyxxy(yxxy)xyxyyx = xyyxxy(xyyx)xyxyyx
xyyxxy(yxxyxy)xyyx = xyyxxy(xyyxyx)xyyx
xyyxxy(yx)xyxyyxxy = xyyxxy(xy)xyxyyxxy
xyyxxy(yxxyxy)yxxy = xyyxxy(xyxyyx)yxxy
xyyxxy(yxxy)xyyxxy = xyyxxy(xyyx)xyyxxy
xyyxxy(yxxyxy)yxxy = xyyxxy(xyyxyx)yxxy
xyyxxy(yx)xyxyyxyx = xyyxxy(xy)xyxyyxyx
xyyxxy(yxxy)xyyxyx = xyyxxy(xyyx)xyyxyx
xyyxxy(yx)xyxyyyxx = xyyxxy(xy)xyxyyyxx
xyyxxy(yxxy)xyyyxx = xyyxxy(xyyx)xyyyxx
xyyxxy(yx)xyyxxxyy = xyyxxy(xy)xyyxxxyy
xyyxxy(yxxy)yxxxyy = xyyxxy(xyyx)yxxxyy
xyyxxy(yx)xyyxxyxy = xyyxxy(xy)xyyxxyxy
xyyxxy(yxxy)yxxyxy = xyyxxy(xyyx)yxxyxy
xyyxxy(yxxyyx)xyyx = xyyxxy(xyxyxy)xyyx
xyyxxy(yx)xyyxxyyx = xyyxxy(xy)xyyxxyyx
xyyxxy(yxxyyx)xyyx = xyyxxy(xyyxxy)xyyx
xyyxxy(yxxy)yxxyyx = xyyxxy(xyyx)yxxyyx
xyyxxyyxxy(yx)xyyx = xyyxxyyxxy(xy)xyyx
xyyxxy(yxxyyx)yxxy = xyyxxy(xyxyxy)yxxy
xyyxxy(yx)xyyxyxxy = xyyxxy(xy)xyyxyxxy
xyyxxy(yxxyyx)yxxy = xyyxxy(xyyxxy)yxxy
xyyxxy(yxxy)yxyxxy = xyyxxy(xyyx)yxyxxy
xyyxxyyxxy(yx)yxxy = xyyxxyyxxy(xy)yxxy
xyyxxy(yx)xyyxyxyx = xyyxxy(xy)xyyxyxyx
xyyxxy(yx)xyyxyyxx = xyyxxy(xy)xyyxyyxx
xyyxxy(yx)xyyyxxxy = xyyxxy(xy)xyyyxxxy
xyyxxy(yxxy)yyxxxy = xyyxxy(xyyx)yyxxxy
xyyxxy(yx)xyyyxxyx = xyyxxy(xy)xyyyxxyx
xyyxxy(yx)xyyyxyxx = xyyxxy(xy)xyyyxyxx
xyyxxy(yx)xyyyyxxx = xyyxxy(xy)xyyyyxxx
xyyxxy(yx)yxxxxyyy = xyyxxy(xy)yxxxxyyy
xyyxxy(yx)yxxxyxyy = xyyxxy(xy)yxxxyxyy
xyyxxy(yx)yxxxyyxy = xyyxxy(xy)yxxxyyxy
xyyxxy(yxyx)xxyyyx = xyyxxy(xyxy)xxyyyx
xyyxxy(yx)yxxxyyyx = xyyxxy(xy)yxxxyyyx
xyyxxyyx(yx)xxyyyx = xyyxxyyx(xy)xxyyyx
xyyxxy(yx)yxxyxxyy = xyyxxy(xy)yxxyxxyy
xyyxxy(yx)yxxyxyxy = xyyxxy(xy)yxxyxyxy
xyyxxy(yxyx)xyxyyx = xyyxxy(xyxy)xyxyyx
xyyxxy(yxyxxy)xyyx = xyyxxy(xyxyyx)xyyx
xyyxxy(yx)yxxyxyyx = xyyxxy(xy)yxxyxyyx
xyyxxy(yxyxxy)xyyx = xyyxxy(xyyxyx)xyyx
xyyxxyyx(yx)xyxyyx = xyyxxyyx(xy)xyxyyx
xyyxxyyx(yxxy)xyyx = xyyxxyyx(xyyx)xyyx
xyyxxy(yxyx)xyyxxy = xyyxxy(xyxy)xyyxxy
xyyxxy(yxyxxy)yxxy = xyyxxy(xyxyyx)yxxy
xyyxxy(yx)yxxyyxxy = xyyxxy(xy)yxxyyxxy
xyyxxy(yxyxxy)yxxy = xyyxxy(xyyxyx)yxxy
xyyxxyyx(yx)xyyxxy = xyyxxyyx(xy)xyyxxy
xyyxxyyx(yxxy)yxxy = xyyxxyyx(xyyx)yxxy
xyyxxy(yxyx)xyyxyx = xyyxxy(xyxy)xyyxyx
xyyxxy(yx)yxxyyxyx = xyyxxy(xy)yxxyyxyx
xyyxxyyx(yx)xyyxyx = xyyxxyyx(xy)xyyxyx
xyyxxy(yxyx)xyyyxx = xyyxxy(xyxy)xyyyxx
xyyxxy(yx)yxxyyyxx = xyyxxy(xy)yxxyyyxx
xyyxxyyx(yx)xyyyxx = xyyxxyyx(xy)xyyyxx
xyyxxy(yxyx)yxxxyy = xyyxxy(xyxy)yxxxyy
xyyxxy(yx)yxyxxxyy = xyyxxy(xy)yxyxxxyy
xyyxxyyx(yx)yxxxyy = xyyxxyyx(xy)yxxxyy
xyyxxy(yxyx)yxxyxy = xyyxxy(xyxy)yxxyxy
xyyxxy(yx)yxyxxyxy = xyyxxy(xy)yxyxxyxy
xyyxxyyx(yx)yxxyxy = xyyxxyyx(xy)yxxyxy
xyyxxy(yxyxyx)xyyx = xyyxxy(xyxyxy)xyyx
xyyxxy(yxyx)yxxyyx = xyyxxy(xyxy)yxxyyx
xyyxxy(yxyxyx)xyyx = xyyxxy(xyyxxy)xyyx
xyyxxy(yx)yxyxxyyx = xyyxxy(xy)yxyxxyyx
xyyxxyyx(yxyx)xyyx = xyyxxyyx(xyxy)xyyx
xyyxxyyx(yx)yxxyyx = xyyxxyyx(xy)yxxyyx
xyyxxyyxyx(yx)xyyx = xyyxxyyxyx(xy)xyyx
xyyxxy(yxyxyx)yxxy = xyyxxy(xyxyxy)yxxy
xyyxxy(yxyx)yxyxxy = xyyxxy(xyxy)yxyxxy
xyyxxy(yxyxyx)yxxy = xyyxxy(xyyxxy)yxxy
xyyxxy(yx)yxyxyxxy = xyyxxy(xy)yxyxyxxy
xyyxxyyx(yxyx)yxxy = xyyxxyyx(xyxy)yxxy
xyyxxyyx(yx)yxyxxy = xyyxxyyx(xy)yxyxxy
xyyxxyyxyx(yx)yxxy = xyyxxyyxyx(xy)yxxy
xyyxxy(yxyx)yyxxxy = xyyxxy(xyxy)yyxxxy
xyyxxy(yx)yxyyxxxy = xyyxxy(xy)yxyyxxxy
xyyxxyyx(yx)yyxxxy = xyyxxyyx(xy)yyxxxy
xyyxxy(yx)yyxxxxyy = xyyxxy(xy)yyxxxxyy
xyyxxy(yx)yyxxxyxy = xyyxxy(xy)yyxxxyxy
xyyxxy(yx)yyxxxyyx = xyyxxy(xy)yyxxxyyx
xyyxxy(yx)yyxxyxxy = xyyxxy(xy)yyxxyxxy
xyyxxy(yx)yyxyxxxy = xyyxxy(xy)yyxyxxxy
xyyxxy(yx)yyyxxxxy = xyyxxy(xy)yyyxxxxy
xyyxxyyyxx(yx)xyxy = xyyxxyyyxx(xy)xyxy
xyyxxyyyxx(yx)xyyx = xyyxxyyyxx(xy)xyyx
xyyxxyyyxx(yx)yxxy = xyyxxyyyxx(xy)yxxy
xyyxxyy(yx)xyyyxxx = xyyxxyy(xy)xyyyxxx
xyyxxyyyx(yx)xyyxx = xyyxxyyyx(xy)xyyxx
xyyxxyyyx(yx)yxxxy = xyyxxyyyx(xy)yxxxy
xyyxxyyyx(yx)yxxyx = xyyxxyyyx(xy)yxxyx
xyyxxyy(yx)yxyyxxx = xyyxxyy(xy)yxyyxxx
xyyxxy(yyx)yyxxxxy = xyyxxy(xyy)yyxxxxy
xyyxxyy(yx)yyxxxxy = xyyxxyy(xy)yyxxxxy
xyyxxyy(yx)yyxxxyx = xyyxxyy(xy)yyxxxyx
xyyxxyy(yx)yyxxyxx = xyyxxyy(xy)yyxxyxx
xyyxxyyyyxx(yx)xyx = xyyxxyyyyxx(xy)xyx
xyyx(yxxx)xxyyyyyx = xyyx(xxxy)xxyyyyyx
xyyx(yxx)xxxyyyyyx = xyyx(xxy)xxxyyyyyx
xyyx(yx)xxxxyyyyyx = xyyx(xy)xxxxyyyyyx
xyyx(yxx)xxyxyyyyx = xyyx(xxy)xxyxyyyyx
xyyx(yx)xxxyxyyyyx = xyyx(xy)xxxyxyyyyx
xyyx(yxx)xxyyxyyyx = xyyx(xxy)xxyyxyyyx
xyyx(yx)xxxyyxyyyx = xyyx(xy)xxxyyxyyyx
xyyxyxxxxyy(yx)yxy = xyyxyxxxxyy(xy)yxy
xyyx(yxx)xxyyyxyyx = xyyx(xxy)xxyyyxyyx
xyyx(yx)xxxyyyxyyx = xyyx(xy)xxxyyyxyyx
xyyx(yxx)xxyyyyxxy = xyyx(xxy)xxyyyyxxy
xyyx(yx)xxxyyyyxxy = xyyx(xy)xxxyyyyxxy
xyyx(yxx)xxyyyyxyx = xyyx(xxy)xxyyyyxyx
xyyx(yx)xxxyyyyxyx = xyyx(xy)xxxyyyyxyx
xyyx(yxx)xxyyyyyxx = xyyx(xxy)xxyyyyyxx
xyyx(yx)xxxyyyyyxx = xyyx(xy)xxxyyyyyxx
xyyx(yxx)xyxxyyyyx = xyyx(xxy)xyxxyyyyx
xyyx(yxxxy)xxyyyyx = xyyx(xxyyx)xxyyyyx
xyyx(yx)xxyxxyyyyx = xyyx(xy)xxyxxyyyyx
xyyx(yxxxy)xxyyyyx = xyyx(xyxyx)xxyyyyx
xyyx(yxxxy)xxyyyyx = xyyx(xyyxx)xxyyyyx
xyyx(yx)xxyxyxyyyx = xyyx(xy)xxyxyxyyyx
xyyx(yxxxyxy)xyyyx = xyyx(xyxxyyx)xyyyx
xyyx(yx)xxyxyyxyyx = xyyx(xy)xxyxyyxyyx
xyyx(yx)xxyxyyyxxy = xyyx(xy)xxyxyyyxxy
xyyx(yx)xxyxyyyxyx = xyyx(xy)xxyxyyyxyx
xyyx(yx)xxyxyyyyxx = xyyx(xy)xxyxyyyyxx
xyyxyxxxy(yx)xyyxy = xyyxyxxxy(xy)xyyxy
xyyx(yxxxyyx)xyyyx = xyyx(xyxxyxy)xyyyx
xyyx(yx)xxyyxxyyyx = xyyx(xy)xxyyxxyyyx
xyyxyxxxy(yx)xyyyx = xyyxyxxxy(xy)xyyyx
xyyxyxxxy(yx)yxxyy = xyyxyxxxy(xy)yxxyy
xyyx(yx)xxyyxyxyyx = xyyx(xy)xxyyxyxyyx
xyyx(yxxxyyxy)xyyx = xyyx(xyxxyyyx)xyyx
xyyx(yx)xxyyxyyxxy = xyyx(xy)xxyyxyyxxy
xyyx(yxxxyyxy)yxxy = xyyx(xyxxyyyx)yxxy
xyyx(yx)xxyyxyyxyx = xyyx(xy)xxyyxyyxyx
xyyx(yxxxyyxy)yxyx = xyyx(xyxxyyyx)yxyx
xyyx(yx)xxyyxyyyxx = xyyx(xy)xxyyxyyyxx
xyyx(yx)xxyyyxxxyy = xyyx(xy)xxyyyxxxyy
xyyx(yx)xxyyyxxyxy = xyyx(xy)xxyyyxxyxy
xyyx(yxxxyyyx)xyyx = xyyx(xyxxyyxy)xyyx
xyyx(yx)xxyyyxxyyx = xyyx(xy)xxyyyxxyyx
xyyxyxxxyy(yx)xyyx = xyyxyxxxyy(xy)xyyx
xyyx(yxxxyyyx)yxxy = xyyx(xyxxyyxy)yxxy
xyyx(yx)xxyyyxyxxy = xyyx(xy)xxyyyxyxxy
xyyxyxxxyy(yx)yxxy = xyyxyxxxyy(xy)yxxy
xyyx(yxxxyyyx)yxyx = xyyx(xyxxyyxy)yxyx
xyyx(yx)xxyyyxyxyx = xyyx(xy)xxyyyxyxyx
xyyxyxxxyy(yx)yxyx = xyyxyxxxyy(xy)yxyx
xyyx(yx)xxyyyxyyxx = xyyx(xy)xxyyyxyyxx
xyyx(yx)xxyyyyxxxy = xyyx(xy)xxyyyyxxxy
xyyx(yx)xxyyyyxxyx = xyyx(xy)xxyyyyxxyx
xyyx(yx)xxyyyyxyxx = xyyx(xy)xxyyyyxyxx
xyyx(yx)xxyyyyyxxx = xyyx(xy)xxyyyyyxxx
xyyxyxx(yx)xxyyxyy = xyyxyxx(xy)xxyyxyy
xyyxyxx(yx)xxyyyxy = xyyxyxx(xy)xxyyyxy
xyyx(yxxyx)xxyyyyx = xyyx(xxyxy)xxyyyyx
xyyx(yxx)yxxxyyyyx = xyyx(xxy)yxxxyyyyx
xyyx(yxxyx)xxyyyyx = xyyx(xyxxy)xxyyyyx
xyyx(yx)xyxxxyyyyx = xyyx(xy)xyxxxyyyyx
xyyx(yxxy)xxxyyyyx = xyyx(xyyx)xxxyyyyx
xyyxyxx(yx)xxyyyyx = xyyxyxx(xy)xxyyyyx
xyyxyxx(yx)xyxxyyy = xyyxyxx(xy)xyxxyyy
xyyx(yx)xyxxyxyyyx = xyyx(xy)xyxxyxyyyx
xyyx(yxxy)xxyxyyyx = xyyx(xyyx)xxyxyyyx
xyyx(yx)xyxxyyxyyx = xyyx(xy)xyxxyyxyyx
xyyx(yxxy)xxyyxyyx = xyyx(xyyx)xxyyxyyx
xyyx(yx)xyxxyyyxxy = xyyx(xy)xyxxyyyxxy
xyyx(yxxy)xxyyyxxy = xyyx(xyyx)xxyyyxxy
xyyx(yx)xyxxyyyxyx = xyyx(xy)xyxxyyyxyx
xyyx(yxxy)xxyyyxyx = xyyx(xyyx)xxyyyxyx
xyyx(yx)xyxxyyyyxx = xyyx(xy)xyxxyyyyxx
xyyx(yxxy)xxyyyyxx = xyyx(xyyx)xxyyyyxx
xyyxyxx(yx)yxxxyyy = xyyxyxx(xy)yxxxyyy
xyyx(yx)xyxyxxyyyx = xyyx(xy)xyxyxxyyyx
xyyx(yxxyxy)xxyyyx = xyyx(xyxyyx)xxyyyx
xyyx(yxxy)xyxxyyyx = xyyx(xyyx)xyxxyyyx
xyyx(yxxyxy)xxyyyx = xyyx(xyyxyx)xxyyyx
xyyx(yx)xyxyxyxyyx = xyyx(xy)xyxyxyxyyx
xyyx(yxxyxyxy)xyyx = xyyx(xyxyxyyx)xyyx
xyyx(yxxyxy)xyxyyx = xyyx(xyxyyx)xyxyyx
xyyx(yxxyxyxy)xyyx = xyyx(xyxyyxyx)xyyx
xyyx(yxxy)xyxyxyyx = xyyx(xyyx)xyxyxyyx
xyyx(yxxyxyxy)xyyx = xyyx(xyyxxyyx)xyyx
xyyx(yxxyxy)xyxyyx = xyyx(xyyxyx)xyxyyx
xyyx(yxxyxyxy)xyyx = xyyx(xyyxyxyx)xyyx
xyyx(yx)xyxyxyyxxy = xyyx(xy)xyxyxyyxxy
xyyx(yxxyxyxy)yxxy = xyyx(xyxyxyyx)yxxy
xyyx(yxxyxy)xyyxxy = xyyx(xyxyyx)xyyxxy
xyyx(yxxyxyxy)yxxy = xyyx(xyxyyxyx)yxxy
xyyx(yxxy)xyxyyxxy = xyyx(xyyx)xyxyyxxy
xyyx(yxxyxyxy)yxxy = xyyx(xyyxxyyx)yxxy
xyyx(yxxyxy)xyyxxy = xyyx(xyyxyx)xyyxxy
xyyx(yxxyxyxy)yxxy = xyyx(xyyxyxyx)yxxy
xyyx(yx)xyxyxyyxyx = xyyx(xy)xyxyxyyxyx
xyyx(yxxyxy)xyyxyx = xyyx(xyxyyx)xyyxyx
xyyx(yxxy)xyxyyxyx = xyyx(xyyx)xyxyyxyx
xyyx(yxxyxy)xyyxyx = xyyx(xyyxyx)xyyxyx
xyyx(yx)xyxyxyyyxx = xyyx(xy)xyxyxyyyxx
xyyx(yxxyxy)xyyyxx = xyyx(xyxyyx)xyyyxx
xyyx(yxxy)xyxyyyxx = xyyx(xyyx)xyxyyyxx
xyyx(yxxyxy)xyyyxx = xyyx(xyyxyx)xyyyxx
xyyx(yx)xyxyyxxxyy = xyyx(xy)xyxyyxxxyy
xyyx(yxxyxy)yxxxyy = xyyx(xyxyyx)yxxxyy
xyyx(yxxy)xyyxxxyy = xyyx(xyyx)xyyxxxyy
xyyx(yxxyxy)yxxxyy = xyyx(xyyxyx)yxxxyy
xyyx(yx)xyxyyxxyxy = xyyx(xy)xyxyyxxyxy
xyyx(yxxyxy)yxxyxy = xyyx(xyxyyx)yxxyxy
xyyx(yxxy)xyyxxyxy = xyyx(xyyx)xyyxxyxy
xyyx(yxxyxy)yxxyxy = xyyx(xyyxyx)yxxyxy
xyyx(yxxyxyyx)xyyx = xyyx(xyxyxyxy)xyyx
xyyx(yx)xyxyyxxyyx = xyyx(xy)xyxyyxxyyx
xyyx(yxxyxyyx)xyyx = xyyx(xyxyyxxy)xyyx
xyyx(yxxyxy)yxxyyx = xyyx(xyxyyx)yxxyyx
xyyx(yxxyxyyx)xyyx = xyyx(xyyxxyxy)xyyx
xyyx(yxxy)xyyxxyyx = xyyx(xyyx)xyyxxyyx
xyyx(yxxyxyyx)xyyx = xyyx(xyyxyxxy)xyyx
xyyx(yxxyxy)yxxyyx = xyyx(xyyxyx)yxxyyx
xyyxyxxyxy(yx)xyyx = xyyxyxxyxy(xy)xyyx
xyyx(yxxyxyyx)yxxy = xyyx(xyxyxyxy)yxxy
xyyx(yx)xyxyyxyxxy = xyyx(xy)xyxyyxyxxy
xyyx(yxxyxyyx)yxxy = xyyx(xyxyyxxy)yxxy
xyyx(yxxyxy)yxyxxy = xyyx(xyxyyx)yxyxxy
xyyx(yxxyxyyx)yxxy = xyyx(xyyxxyxy)yxxy
xyyx(yxxy)xyyxyxxy = xyyx(xyyx)xyyxyxxy
xyyx(yxxyxyyx)yxxy = xyyx(xyyxyxxy)yxxy
xyyx(yxxyxy)yxyxxy = xyyx(xyyxyx)yxyxxy
xyyxyxxyxy(yx)yxxy = xyyxyxxyxy(xy)yxxy
xyyx(yx)xyxyyxyxyx = xyyx(xy)xyxyyxyxyx
xyyx(yxxy)xyyxyxyx = xyyx(xyyx)xyyxyxyx
xyyx(yx)xyxyyxyyxx = xyyx(xy)xyxyyxyyxx
xyyx(yxxy)xyyxyyxx = xyyx(xyyx)xyyxyyxx
xyyx(yx)xyxyyyxxxy = xyyx(xy)xyxyyyxxxy
xyyx(yxxyxy)yyxxxy = xyyx(xyxyyx)yyxxxy
xyyx(yxxy)xyyyxxxy = xyyx(xyyx)xyyyxxxy
xyyx(yxxyxy)yyxxxy = xyyx(xyyxyx)yyxxxy
xyyx(yx)xyxyyyxxyx = xyyx(xy)xyxyyyxxyx
xyyx(yxxy)xyyyxxyx = xyyx(xyyx)xyyyxxyx
xyyx(yx)xyxyyyxyxx = xyyx(xy)xyxyyyxyxx
xyyx(yxxy)xyyyxyxx = xyyx(xyyx)xyyyxyxx
xyyx(yx)xyxyyyyxxx = xyyx(xy)xyxyyyyxxx
xyyx(yxxy)xyyyyxxx = xyyx(xyyx)xyyyyxxx
xyyx(yx)xyyxxxxyyy = xyyx(xy)xyyxxxxyyy
xyyx(yxxy)yxxxxyyy = xyyx(xyyx)yxxxxyyy
xyyx(yx)xyyxxxyxyy = xyyx(xy)xyyxxxyxyy
xyyx(yxxy)yxxxyxyy = xyyx(xyyx)yxxxyxyy
xyyx(yx)xyyxxxyyxy = xyyx(xy)xyyxxxyyxy
xyyx(yxxy)yxxxyyxy = xyyx(xyyx)yxxxyyxy
xyyx(yxxyyx)xxyyyx = xyyx(xyxyxy)xxyyyx
xyyx(yx)xyyxxxyyyx = xyyx(xy)xyyxxxyyyx
xyyx(yxxyyx)xxyyyx = xyyx(xyyxxy)xxyyyx
xyyx(yxxy)yxxxyyyx = xyyx(xyyx)yxxxyyyx
xyyxyxxy(yx)xxyyyx = xyyxyxxy(xy)xxyyyx
xyyx(yx)xyyxxyxxyy = xyyx(xy)xyyxxyxxyy
xyyx(yxxy)yxxyxxyy = xyyx(xyyx)yxxyxxyy
xyyx(yx)xyyxxyxyxy = xyyx(xy)xyyxxyxyxy
xyyx(yxxy)yxxyxyxy = xyyx(xyyx)yxxyxyxy
xyyx(yxxyyx)xyxyyx = xyyx(xyxyxy)xyxyyx
xyyx(yxxyyxxy)xyyx = xyyx(xyxyxyyx)xyyx
xyyx(yx)xyyxxyxyyx = xyyx(xy)xyyxxyxyyx
xyyx(yxxyyxxy)xyyx = xyyx(xyxyyxyx)xyyx
xyyx(yxxyyx)xyxyyx = xyyx(xyyxxy)xyxyyx
xyyx(yxxyyxxy)xyyx = xyyx(xyyxxyyx)xyyx
xyyx(yxxy)yxxyxyyx = xyyx(xyyx)yxxyxyyx
xyyx(yxxyyxxy)xyyx = xyyx(xyyxyxyx)xyyx
xyyxyxxy(yx)xyxyyx = xyyxyxxy(xy)xyxyyx
xyyxyxxy(yxxy)xyyx = xyyxyxxy(xyyx)xyyx
xyyx(yxxyyx)xyyxxy = xyyx(xyxyxy)xyyxxy
xyyx(yxxyyxxy)yxxy = xyyx(xyxyxyyx)yxxy
xyyx(yx)xyyxxyyxxy = xyyx(xy)xyyxxyyxxy
xyyx(yxxyyxxy)yxxy = xyyx(xyxyyxyx)yxxy
xyyx(yxxyyx)xyyxxy = xyyx(xyyxxy)xyyxxy
xyyx(yxxyyxxy)yxxy = xyyx(xyyxxyyx)yxxy
xyyx(yxxy)yxxyyxxy = xyyx(xyyx)yxxyyxxy
xyyx(yxxyyxxy)yxxy = xyyx(xyyxyxyx)yxxy
xyyxyxxy(yx)xyyxxy = xyyxyxxy(xy)xyyxxy
xyyxyxxy(yxxy)yxxy = xyyxyxxy(xyyx)yxxy
xyyx(yxxyyx)xyyxyx = xyyx(xyxyxy)xyyxyx
xyyx(yx)xyyxxyyxyx = xyyx(xy)xyyxxyyxyx
xyyx(yxxyyx)xyyxyx = xyyx(xyyxxy)xyyxyx
xyyx(yxxy)yxxyyxyx = xyyx(xyyx)yxxyyxyx
xyyxyxxy(yx)xyyxyx = xyyxyxxy(xy)xyyxyx
xyyx(yxxyyx)xyyyxx = xyyx(xyxyxy)xyyyxx
xyyx(yx)xyyxxyyyxx = xyyx(xy)xyyxxyyyxx
xyyx(yxxyyx)xyyyxx = xyyx(xyyxxy)xyyyxx
xyyx(yxxy)yxxyyyxx = xyyx(xyyx)yxxyyyxx
xyyxyxxy(yx)xyyyxx = xyyxyxxy(xy)xyyyxx
xyyx(yxxyyx)yxxxyy = xyyx(xyxyxy)yxxxyy
xyyx(yx)xyyxyxxxyy = xyyx(xy)xyyxyxxxyy
xyyx(yxxyyx)yxxxyy = xyyx(xyyxxy)yxxxyy
xyyx(yxxy)yxyxxxyy = xyyx(xyyx)yxyxxxyy
xyyxyxxy(yx)yxxxyy = xyyxyxxy(xy)yxxxyy
xyyx(yxxyyx)yxxyxy = xyyx(xyxyxy)yxxyxy
xyyx(yx)xyyxyxxyxy = xyyx(xy)xyyxyxxyxy
xyyx(yxxyyx)yxxyxy = xyyx(xyyxxy)yxxyxy
xyyx(yxxy)yxyxxyxy = xyyx(xyyx)yxyxxyxy
xyyxyxxy(yx)yxxyxy = xyyxyxxy(xy)yxxyxy
xyyx(yxxyyxyx)xyyx = xyyx(xyxyxyxy)xyyx
xyyx(yxxyyx)yxxyyx = xyyx(xyxyxy)yxxyyx
xyyx(yxxyyxyx)xyyx = xyyx(xyxyyxxy)xyyx
xyyx(yx)xyyxyxxyyx = xyyx(xy)xyyxyxxyyx
xyyx(yxxyyxyx)xyyx = xyyx(xyyxxyxy)xyyx
xyyx(yxxyyx)yxxyyx = xyyx(xyyxxy)yxxyyx
xyyx(yxxyyxyx)xyyx = xyyx(xyyxyxxy)xyyx
xyyx(yxxy)yxyxxyyx = xyyx(xyyx)yxyxxyyx
xyyxyxxy(yxyx)xyyx = xyyxyxxy(xyxy)xyyx
xyyxyxxy(yx)yxxyyx = xyyxyxxy(xy)yxxyyx
xyyxyxxyyx(yx)xyyx = xyyxyxxyyx(xy)xyyx
xyyx(yxxyyxyx)yxxy = xyyx(xyxyxyxy)yxxy
xyyx(yxxyyx)yxyxxy = xyyx(xyxyxy)yxyxxy
xyyx(yxxyyxyx)yxxy = xyyx(xyxyyxxy)yxxy
xyyx(yx)xyyxyxyxxy = xyyx(xy)xyyxyxyxxy
xyyx(yxxyyxyx)yxxy = xyyx(xyyxxyxy)yxxy
xyyx(yxxyyx)yxyxxy = xyyx(xyyxxy)yxyxxy
xyyx(yxxyyxyx)yxxy = xyyx(xyyxyxxy)yxxy
xyyx(yxxy)yxyxyxxy = xyyx(xyyx)yxyxyxxy
xyyxyxxy(yxyx)yxxy = xyyxyxxy(xyxy)yxxy
xyyxyxxy(yx)yxyxxy = xyyxyxxy(xy)yxyxxy
xyyxyxxyyx(yx)yxxy = xyyxyxxyyx(xy)yxxy
xyyx(yx)xyyxyxyxyx = xyyx(xy)xyyxyxyxyx
xyyx(yx)xyyxyxyyxx = xyyx(xy)xyyxyxyyxx
xyyx(yxxyyx)yyxxxy = xyyx(xyxyxy)yyxxxy
xyyx(yx)xyyxyyxxxy = xyyx(xy)xyyxyyxxxy
xyyx(yxxyyx)yyxxxy = xyyx(xyyxxy)yyxxxy
xyyx(yxxy)yxyyxxxy = xyyx(xyyx)yxyyxxxy
xyyxyxxy(yx)yyxxxy = xyyxyxxy(xy)yyxxxy
xyyx(yx)xyyxyyxxyx = xyyx(xy)xyyxyyxxyx
xyyx(yx)xyyxyyxyxx = xyyx(xy)xyyxyyxyxx
xyyx(yx)xyyxyyyxxx = xyyx(xy)xyyxyyyxxx
xyyx(yx)xyyyxxxxyy = xyyx(xy)xyyyxxxxyy
xyyx(yxxy)yyxxxxyy = xyyx(xyyx)yyxxxxyy
xyyx(yx)xyyyxxxyxy = xyyx(xy)xyyyxxxyxy
xyyx(yxxy)yyxxxyxy = xyyx(xyyx)yyxxxyxy
xyyx(yx)xyyyxxxyyx = xyyx(xy)xyyyxxxyyx
xyyx(yxxy)yyxxxyyx = xyyx(xyyx)yyxxxyyx
xyyx(yx)xyyyxxyxxy = xyyx(xy)xyyyxxyxxy
xyyx(yxxy)yyxxyxxy = xyyx(xyyx)yyxxyxxy
xyyx(yx)xyyyxxyxyx = xyyx(xy)xyyyxxyxyx
xyyx(yx)xyyyxxyyxx = xyyx(xy)xyyyxxyyxx
xyyx(yx)xyyyxyxxxy = xyyx(xy)xyyyxyxxxy
xyyx(yxxy)yyxyxxxy = xyyx(xyyx)yyxyxxxy
xyyx(yx)xyyyxyxxyx = xyyx(xy)xyyyxyxxyx
xyyx(yx)xyyyxyxyxx = xyyx(xy)xyyyxyxyxx
xyyx(yx)xyyyxyyxxx = xyyx(xy)xyyyxyyxxx
xyyx(yx)xyyyyxxxxy = xyyx(xy)xyyyyxxxxy
xyyx(yxxy)yyyxxxxy = xyyx(xyyx)yyyxxxxy
xyyx(yxxyy)yyxxxxy = xyyx(xyyyx)yyxxxxy
xyyx(yx)xyyyyxxxyx = xyyx(xy)xyyyyxxxyx
xyyx(yx)xyyyyxxyxx = xyyx(xy)xyyyyxxyxx
xyyx(yx)xyyyyxyxxx = xyyx(xy)xyyyyxyxxx
xyyx(yx)xyyyyyxxxx = xyyx(xy)xyyyyyxxxx
xyyx(yx)yxxxxxyyyy = xyyx(xy)yxxxxxyyyy
xyyx(yx)yxxxxyxyyy = xyyx(xy)yxxxxyxyyy
xyyx(yx)yxxxxyyxyy = xyyx(xy)yxxxxyyxyy
xyyx(yx)yxxxxyyyxy = xyyx(xy)yxxxxyyyxy
xyyx(yxyxx)xxyyyyx = xyyx(xxyxy)xxyyyyx
xyyx(yxyx)xxxyyyyx = xyyx(xxyy)xxxyyyyx
xyyx(yxyxx)xxyyyyx = xyyx(xyxxy)xxyyyyx
xyyx(yxyx)xxxyyyyx = xyyx(xyxy)xxxyyyyx
xyyx(yx)yxxxxyyyyx = xyyx(xy)yxxxxyyyyx
xyyxyx(yxx)xxyyyyx = xyyxyx(xxy)xxyyyyx
xyyxyx(yx)xxxyyyyx = xyyxyx(xy)xxxyyyyx
xyyx(yx)yxxxyxxyyy = xyyx(xy)yxxxyxxyyy
xyyx(yx)yxxxyxyxyy = xyyx(xy)yxxxyxyxyy
xyyx(yx)yxxxyxyyxy = xyyx(xy)yxxxyxyyxy
xyyx(yxyx)xxyxyyyx = xyyx(xyxy)xxyxyyyx
xyyx(yx)yxxxyxyyyx = xyyx(xy)yxxxyxyyyx
xyyxyx(yx)xxyxyyyx = xyyxyx(xy)xxyxyyyx
xyyx(yx)yxxxyyxxyy = xyyx(xy)yxxxyyxxyy
xyyx(yx)yxxxyyxyxy = xyyx(xy)yxxxyyxyxy
xyyx(yxyx)xxyyxyyx = xyyx(xyxy)xxyyxyyx
xyyx(yx)yxxxyyxyyx = xyyx(xy)yxxxyyxyyx
xyyxyx(yx)xxyyxyyx = xyyxyx(xy)xxyyxyyx
xyyx(yxyx)xxyyyxxy = xyyx(xyxy)xxyyyxxy
xyyx(yx)yxxxyyyxxy = xyyx(xy)yxxxyyyxxy
xyyxyx(yx)xxyyyxxy = xyyxyx(xy)xxyyyxxy
xyyx(yxyx)xxyyyxyx = xyyx(xyxy)xxyyyxyx
xyyx(yx)yxxxyyyxyx = xyyx(xy)yxxxyyyxyx
xyyxyx(yx)xxyyyxyx = xyyxyx(xy)xxyyyxyx
xyyx(yxyx)xxyyyyxx = xyyx(xyxy)xxyyyyxx
xyyx(yx)yxxxyyyyxx = xyyx(xy)yxxxyyyyxx
xyyxyx(yx)xxyyyyxx = xyyxyx(xy)xxyyyyxx
xyyx(yx)yxxyxxxyyy = xyyx(xy)yxxyxxxyyy
xyyx(yx)yxxyxxyxyy = xyyx(xy)yxxyxxyxyy
xyyx(yx)yxxyxxyyxy = xyyx(xy)yxxyxxyyxy
xyyx(yxyx)xyxxyyyx = xyyx(xyxy)xyxxyyyx
xyyx(yxyxxy)xxyyyx = xyyx(xyxyyx)xxyyyx
xyyx(yx)yxxyxxyyyx = xyyx(xy)yxxyxxyyyx
xyyx(yxyxxy)xxyyyx = xyyx(xyyxyx)xxyyyx
xyyxyx(yx)xyxxyyyx = xyyxyx(xy)xyxxyyyx
xyyxyx(yxxy)xxyyyx = xyyxyx(xyyx)xxyyyx
xyyx(yx)yxxyxyxxyy = xyyx(xy)yxxyxyxxyy
xyyx(yx)yxxyxyxyxy = xyyx(xy)yxxyxyxyxy
xyyx(yxyx)xyxyxyyx = xyyx(xyxy)xyxyxyyx
xyyx(yxyxxyxy)xyyx = xyyx(xyxyxyyx)xyyx
xyyx(yxyxxy)xyxyyx = xyyx(xyxyyx)xyxyyx
xyyx(yxyxxyxy)xyyx = xyyx(xyxyyxyx)xyyx
xyyx(yx)yxxyxyxyyx = xyyx(xy)yxxyxyxyyx
xyyx(yxyxxyxy)xyyx = xyyx(xyyxxyyx)xyyx
xyyx(yxyxxy)xyxyyx = xyyx(xyyxyx)xyxyyx
xyyx(yxyxxyxy)xyyx = xyyx(xyyxyxyx)xyyx
xyyxyx(yx)xyxyxyyx = xyyxyx(xy)xyxyxyyx
xyyxyx(yxxyxy)xyyx = xyyxyx(xyxyyx)xyyx
xyyxyx(yxxy)xyxyyx = xyyxyx(xyyx)xyxyyx
xyyxyx(yxxyxy)xyyx = xyyxyx(xyyxyx)xyyx
xyyx(yxyx)xyxyyxxy = xyyx(xyxy)xyxyyxxy
xyyx(yxyxxyxy)yxxy = xyyx(xyxyxyyx)yxxy
xyyx(yxyxxy)xyyxxy = xyyx(xyxyyx)xyyxxy
xyyx(yxyxxyxy)yxxy = xyyx(xyxyyxyx)yxxy
xyyx(yx)yxxyxyyxxy = xyyx(xy)yxxyxyyxxy
xyyx(yxyxxyxy)yxxy = xyyx(xyyxxyyx)yxxy
xyyx(yxyxxy)xyyxxy = xyyx(xyyxyx)xyyxxy
xyyx(yxyxxyxy)yxxy = xyyx(xyyxyxyx)yxxy
xyyxyx(yx)xyxyyxxy = xyyxyx(xy)xyxyyxxy
xyyxyx(yxxyxy)yxxy = xyyxyx(xyxyyx)yxxy
xyyxyx(yxxy)xyyxxy = xyyxyx(xyyx)xyyxxy
xyyxyx(yxxyxy)yxxy = xyyxyx(xyyxyx)yxxy
xyyx(yxyx)xyxyyxyx = xyyx(xyxy)xyxyyxyx
xyyx(yxyxxy)xyyxyx = xyyx(xyxyyx)xyyxyx
xyyx(yx)yxxyxyyxyx = xyyx(xy)yxxyxyyxyx
xyyx(yxyxxy)xyyxyx = xyyx(xyyxyx)xyyxyx
xyyxyx(yx)xyxyyxyx = xyyxyx(xy)xyxyyxyx
xyyxyx(yxxy)xyyxyx = xyyxyx(xyyx)xyyxyx
xyyx(yxyx)xyxyyyxx = xyyx(xyxy)xyxyyyxx
xyyx(yxyxxy)xyyyxx = xyyx(xyxyyx)xyyyxx
xyyx(yx)yxxyxyyyxx = xyyx(xy)yxxyxyyyxx
xyyx(yxyxxy)xyyyxx = xyyx(xyyxyx)xyyyxx
xyyxyx(yx)xyxyyyxx = xyyxyx(xy)xyxyyyxx
xyyxyx(yxxy)xyyyxx = xyyxyx(xyyx)xyyyxx
xyyx(yxyx)xyyxxxyy = xyyx(xyxy)xyyxxxyy
xyyx(yxyxxy)yxxxyy = xyyx(xyxyyx)yxxxyy
xyyx(yx)yxxyyxxxyy = xyyx(xy)yxxyyxxxyy
xyyx(yxyxxy)yxxxyy = xyyx(xyyxyx)yxxxyy
xyyxyx(yx)xyyxxxyy = xyyxyx(xy)xyyxxxyy
xyyxyx(yxxy)yxxxyy = xyyxyx(xyyx)yxxxyy
xyyx(yxyx)xyyxxyxy = xyyx(xyxy)xyyxxyxy
xyyx(yxyxxy)yxxyxy = xyyx(xyxyyx)yxxyxy
xyyx(yx)yxxyyxxyxy = xyyx(xy)yxxyyxxyxy
xyyx(yxyxxy)yxxyxy = xyyx(xyyxyx)yxxyxy
xyyxyx(yx)xyyxxyxy = xyyxyx(xy)xyyxxyxy
xyyxyx(yxxy)yxxyxy = xyyxyx(xyyx)yxxyxy
xyyx(yxyxxyyx)xyyx = xyyx(xyxyxyxy)xyyx
xyyx(yxyx)xyyxxyyx = xyyx(xyxy)xyyxxyyx
xyyx(yxyxxyyx)xyyx = xyyx(xyxyyxxy)xyyx
xyyx(yxyxxy)yxxyyx = xyyx(xyxyyx)yxxyyx
xyyx(yxyxxyyx)xyyx = xyyx(xyyxxyxy)xyyx
xyyx(yx)yxxyyxxyyx = xyyx(xy)yxxyyxxyyx
xyyx(yxyxxyyx)xyyx = xyyx(xyyxyxxy)xyyx
xyyx(yxyxxy)yxxyyx = xyyx(xyyxyx)yxxyyx
xyyxyx(yxxyyx)xyyx = xyyxyx(xyxyxy)xyyx
xyyxyx(yx)xyyxxyyx = xyyxyx(xy)xyyxxyyx
xyyxyx(yxxyyx)xyyx = xyyxyx(xyyxxy)xyyx
xyyxyx(yxxy)yxxyyx = xyyxyx(xyyx)yxxyyx
xyyxyxyxxy(yx)xyyx = xyyxyxyxxy(xy)xyyx
xyyx(yxyxxyyx)yxxy = xyyx(xyxyxyxy)yxxy
xyyx(yxyx)xyyxyxxy = xyyx(xyxy)xyyxyxxy
xyyx(yxyxxyyx)yxxy = xyyx(xyxyyxxy)yxxy
xyyx(yxyxxy)yxyxxy = xyyx(xyxyyx)yxyxxy
xyyx(yxyxxyyx)yxxy = xyyx(xyyxxyxy)yxxy
xyyx(yx)yxxyyxyxxy = xyyx(xy)yxxyyxyxxy
xyyx(yxyxxyyx)yxxy = xyyx(xyyxyxxy)yxxy
xyyx(yxyxxy)yxyxxy = xyyx(xyyxyx)yxyxxy
xyyxyx(yxxyyx)yxxy = xyyxyx(xyxyxy)yxxy
xyyxyx(yx)xyyxyxxy = xyyxyx(xy)xyyxyxxy
xyyxyx(yxxyyx)yxxy = xyyxyx(xyyxxy)yxxy
xyyxyx(yxxy)yxyxxy = xyyxyx(xyyx)yxyxxy
xyyxyxyxxy(yx)yxxy = xyyxyxyxxy(xy)yxxy
xyyx(yxyx)xyyxyxyx = xyyx(xyxy)xyyxyxyx
xyyx(yx)yxxyyxyxyx = xyyx(xy)yxxyyxyxyx
xyyxyx(yx)xyyxyxyx = xyyxyx(xy)xyyxyxyx
xyyx(yxyx)xyyxyyxx = xyyx(xyxy)xyyxyyxx
xyyx(yx)yxxyyxyyxx = xyyx(xy)yxxyyxyyxx
xyyxyx(yx)xyyxyyxx = xyyxyx(xy)xyyxyyxx
xyyx(yxyx)xyyyxxxy = xyyx(xyxy)xyyyxxxy
xyyx(yxyxxy)yyxxxy = xyyx(xyxyyx)yyxxxy
xyyx(yx)yxxyyyxxxy = xyyx(xy)yxxyyyxxxy
xyyx(yxyxxy)yyxxxy = xyyx(xyyxyx)yyxxxy
xyyxyx(yx)xyyyxxxy = xyyxyx(xy)xyyyxxxy
xyyxyx(yxxy)yyxxxy = xyyxyx(xyyx)yyxxxy
xyyx(yxyx)xyyyxxyx = xyyx(xyxy)xyyyxxyx
xyyx(yx)yxxyyyxxyx = xyyx(xy)yxxyyyxxyx
xyyxyx(yx)xyyyxxyx = xyyxyx(xy)xyyyxxyx
xyyx(yxyx)xyyyxyxx = xyyx(xyxy)xyyyxyxx
xyyx(yx)yxxyyyxyxx = xyyx(xy)yxxyyyxyxx
xyyxyx(yx)xyyyxyxx = xyyxyx(xy)xyyyxyxx
xyyx(yxyx)xyyyyxxx = xyyx(xyxy)xyyyyxxx
xyyx(yx)yxxyyyyxxx = xyyx(xy)yxxyyyyxxx
xyyxyx(yx)xyyyyxxx = xyyxyx(xy)xyyyyxxx
xyyx(yxyx)yxxxxyyy = xyyx(xyxy)yxxxxyyy
xyyx(yx)yxyxxxxyyy = xyyx(xy)yxyxxxxyyy
xyyxyx(yx)yxxxxyyy = xyyxyx(xy)yxxxxyyy
xyyx(yxyx)yxxxyxyy = xyyx(xyxy)yxxxyxyy
xyyx(yx)yxyxxxyxyy = xyyx(xy)yxyxxxyxyy
xyyxyx(yx)yxxxyxyy = xyyxyx(xy)yxxxyxyy
xyyx(yxyx)yxxxyyxy = xyyx(xyxy)yxxxyyxy
xyyx(yx)yxyxxxyyxy = xyyx(xy)yxyxxxyyxy
xyyxyx(yx)yxxxyyxy = xyyxyx(xy)yxxxyyxy
xyyx(yxyxyx)xxyyyx = xyyx(xyxyxy)xxyyyx
xyyx(yxyx)yxxxyyyx = xyyx(xyxy)yxxxyyyx
xyyx(yxyxyx)xxyyyx = xyyx(xyyxxy)xxyyyx
xyyx(yx)yxyxxxyyyx = xyyx(xy)yxyxxxyyyx
xyyxyx(yxyx)xxyyyx = xyyxyx(xyxy)xxyyyx
xyyxyx(yx)yxxxyyyx = xyyxyx(xy)yxxxyyyx
xyyxyxyx(yx)xxyyyx = xyyxyxyx(xy)xxyyyx
xyyx(yxyx)yxxyxxyy = xyyx(xyxy)yxxyxxyy
xyyx(yx)yxyxxyxxyy = xyyx(xy)yxyxxyxxyy
xyyxyx(yx)yxxyxxyy = xyyxyx(xy)yxxyxxyy
xyyx(yxyx)yxxyxyxy = xyyx(xyxy)yxxyxyxy
xyyx(yx)yxyxxyxyxy = xyyx(xy)yxyxxyxyxy
xyyxyx(yx)yxxyxyxy = xyyxyx(xy)yxxyxyxy
xyyx(yxyxyx)xyxyyx = xyyx(xyxyxy)xyxyyx
xyyx(yxyxyxxy)xyyx = xyyx(xyxyxyyx)xyyx
xyyx(yxyx)yxxyxyyx = xyyx(xyxy)yxxyxyyx
xyyx(yxyxyxxy)xyyx = xyyx(xyxyyxyx)xyyx
xyyx(yxyxyx)xyxyyx = xyyx(xyyxxy)xyxyyx
xyyx(yxyxyxxy)xyyx = xyyx(xyyxxyyx)xyyx
xyyx(yx)yxyxxyxyyx = xyyx(xy)yxyxxyxyyx
xyyx(yxyxyxxy)xyyx = xyyx(xyyxyxyx)xyyx
xyyxyx(yxyx)xyxyyx = xyyxyx(xyxy)xyxyyx
xyyxyx(yxyxxy)xyyx = xyyxyx(xyxyyx)xyyx
xyyxyx(yx)yxxyxyyx = xyyxyx(xy)yxxyxyyx
xyyxyx(yxyxxy)xyyx = xyyxyx(xyyxyx)xyyx
xyyxyxyx(yx)xyxyyx = xyyxyxyx(xy)xyxyyx
xyyxyxyx(yxxy)xyyx = xyyxyxyx(xyyx)xyyx
xyyx(yxyxyx)xyyxxy = xyyx(xyxyxy)xyyxxy
xyyx(yxyxyxxy)yxxy = xyyx(xyxyxyyx)yxxy
xyyx(yxyx)yxxyyxxy = xyyx(xyxy)yxxyyxxy
xyyx(yxyxyxxy)yxxy = xyyx(xyxyyxyx)yxxy
xyyx(yxyxyx)xyyxxy = xyyx(xyyxxy)xyyxxy
xyyx(yxyxyxxy)yxxy = xyyx(xyyxxyyx)yxxy
xyyx(yx)yxyxxyyxxy = xyyx(xy)yxyxxyyxxy
xyyx(yxyxyxxy)yxxy = xyyx(xyyxyxyx)yxxy
xyyxyx(yxyx)xyyxxy = xyyxyx(xyxy)xyyxxy
xyyxyx(yxyxxy)yxxy = xyyxyx(xyxyyx)yxxy
xyyxyx(yx)yxxyyxxy = xyyxyx(xy)yxxyyxxy
xyyxyx(yxyxxy)yxxy = xyyxyx(xyyxyx)yxxy
xyyxyxyx(yx)xyyxxy = xyyxyxyx(xy)xyyxxy
xyyxyxyx(yxxy)yxxy = xyyxyxyx(xyyx)yxxy
xyyx(yxyxyx)xyyxyx = xyyx(xyxyxy)xyyxyx
xyyx(yxyx)yxxyyxyx = xyyx(xyxy)yxxyyxyx
xyyx(yxyxyx)xyyxyx = xyyx(xyyxxy)xyyxyx
xyyx(yx)yxyxxyyxyx = xyyx(xy)yxyxxyyxyx
xyyxyx(yxyx)xyyxyx = xyyxyx(xyxy)xyyxyx
xyyxyx(yx)yxxyyxyx = xyyxyx(xy)yxxyyxyx
xyyxyxyx(yx)xyyxyx = xyyxyxyx(xy)xyyxyx
xyyx(yxyxyx)xyyyxx = xyyx(xyxyxy)xyyyxx
xyyx(yxyx)yxxyyyxx = xyyx(xyxy)yxxyyyxx
xyyx(yxyxyx)xyyyxx = xyyx(xyyxxy)xyyyxx
xyyx(yx)yxyxxyyyxx = xyyx(xy)yxyxxyyyxx
xyyxyx(yxyx)xyyyxx = xyyxyx(xyxy)xyyyxx
xyyxyx(yx)yxxyyyxx = xyyxyx(xy)yxxyyyxx
xyyxyxyx(yx)xyyyxx = xyyxyxyx(xy)xyyyxx
xyyx(yxyxyx)yxxxyy = xyyx(xyxyxy)yxxxyy
xyyx(yxyx)yxyxxxyy = xyyx(xyxy)yxyxxxyy
xyyx(yxyxyx)yxxxyy = xyyx(xyyxxy)yxxxyy
xyyx(yx)yxyxyxxxyy = xyyx(xy)yxyxyxxxyy
xyyxyx(yxyx)yxxxyy = xyyxyx(xyxy)yxxxyy
xyyxyx(yx)yxyxxxyy = xyyxyx(xy)yxyxxxyy
xyyxyxyx(yx)yxxxyy = xyyxyxyx(xy)yxxxyy
xyyx(yxyxyx)yxxyxy = xyyx(xyxyxy)yxxyxy
xyyx(yxyx)yxyxxyxy = xyyx(xyxy)yxyxxyxy
xyyx(yxyxyx)yxxyxy = xyyx(xyyxxy)yxxyxy
xyyx(yx)yxyxyxxyxy = xyyx(xy)yxyxyxxyxy
xyyxyx(yxyx)yxxyxy = xyyxyx(xyxy)yxxyxy
xyyxyx(yx)yxyxxyxy = xyyxyx(xy)yxyxxyxy
xyyxyxyx(yx)yxxyxy = xyyxyxyx(xy)yxxyxy
xyyx(yxyxyxyx)xyyx = xyyx(xyxyxyxy)xyyx
xyyx(yxyxyx)yxxyyx = xyyx(xyxyxy)yxxyyx
xyyx(yxyxyxyx)xyyx = xyyx(xyxyyxxy)xyyx
xyyx(yxyx)yxyxxyyx = xyyx(xyxy)yxyxxyyx
xyyx(yxyxyxyx)xyyx = xyyx(xyyxxyxy)xyyx
xyyx(yxyxyx)yxxyyx = xyyx(xyyxxy)yxxyyx
xyyx(yxyxyxyx)xyyx = xyyx(xyyxyxxy)xyyx
xyyx(yx)yxyxyxxyyx = xyyx(xy)yxyxyxxyyx
xyyxyx(yxyxyx)xyyx = xyyxyx(xyxyxy)xyyx
xyyxyx(yxyx)yxxyyx = xyyxyx(xyxy)yxxyyx
xyyxyx(yxyxyx)xyyx = xyyxyx(xyyxxy)xyyx
xyyxyx(yx)yxyxxyyx = xyyxyx(xy)yxyxxyyx
xyyxyxyx(yxyx)xyyx = xyyxyxyx(xyxy)xyyx
xyyxyxyx(yx)yxxyyx = xyyxyxyx(xy)yxxyyx
xyyxyxyxyx(yx)xyyx = xyyxyxyxyx(xy)xyyx
xyyx(yxyxyxyx)yxxy = xyyx(xyxyxyxy)yxxy
xyyx(yxyxyx)yxyxxy = xyyx(xyxyxy)yxyxxy
xyyx(yxyxyxyx)yxxy = xyyx(xyxyyxxy)yxxy
xyyx(yxyx)yxyxyxxy = xyyx(xyxy)yxyxyxxy
xyyx(yxyxyxyx)yxxy = xyyx(xyyxxyxy)yxxy
xyyx(yxyxyx)yxyxxy = xyyx(xyyxxy)yxyxxy
xyyx(yxyxyxyx)yxxy = xyyx(xyyxyxxy)yxxy
xyyx(yx)yxyxyxyxxy = xyyx(xy)yxyxyxyxxy
xyyxyx(yxyxyx)yxxy = xyyxyx(xyxyxy)yxxy
xyyxyx(yxyx)yxyxxy = xyyxyx(xyxy)yxyxxy
xyyxyx(yxyxyx)yxxy = xyyxyx(xyyxxy)yxxy
xyyxyx(yx)yxyxyxxy = xyyxyx(xy)yxyxyxxy
xyyxyxyx(yxyx)yxxy = xyyxyxyx(xyxy)yxxy
xyyxyxyx(yx)yxyxxy = xyyxyxyx(xy)yxyxxy
xyyxyxyxyx(yx)yxxy = xyyxyxyxyx(xy)yxxy
xyyx(yxyxyx)yyxxxy = xyyx(xyxyxy)yyxxxy
xyyx(yxyx)yxyyxxxy = xyyx(xyxy)yxyyxxxy
xyyx(yxyxyx)yyxxxy = xyyx(xyyxxy)yyxxxy
xyyx(yx)yxyxyyxxxy = xyyx(xy)yxyxyyxxxy
xyyxyx(yxyx)yyxxxy = xyyxyx(xyxy)yyxxxy
xyyxyx(yx)yxyyxxxy = xyyxyx(xy)yxyyxxxy
xyyxyxyx(yx)yyxxxy = xyyxyxyx(xy)yyxxxy
xyyx(yxyx)yyxxxxyy = xyyx(xyxy)yyxxxxyy
xyyx(yx)yxyyxxxxyy = xyyx(xy)yxyyxxxxyy
xyyxyx(yx)yyxxxxyy = xyyxyx(xy)yyxxxxyy
xyyx(yxyx)yyxxxyxy = xyyx(xyxy)yyxxxyxy
xyyx(yx)yxyyxxxyxy = xyyx(xy)yxyyxxxyxy
xyyxyx(yx)yyxxxyxy = xyyxyx(xy)yyxxxyxy
xyyx(yxyx)yyxxxyyx = xyyx(xyxy)yyxxxyyx
xyyx(yx)yxyyxxxyyx = xyyx(xy)yxyyxxxyyx
xyyxyx(yx)yyxxxyyx = xyyxyx(xy)yyxxxyyx
xyyx(yxyx)yyxxyxxy = xyyx(xyxy)yyxxyxxy
xyyx(yx)yxyyxxyxxy = xyyx(xy)yxyyxxyxxy
xyyxyx(yx)yyxxyxxy = xyyxyx(xy)yyxxyxxy
xyyx(yxyx)yyxyxxxy = xyyx(xyxy)yyxyxxxy
xyyx(yx)yxyyxyxxxy = xyyx(xy)yxyyxyxxxy
xyyxyx(yx)yyxyxxxy = xyyxyx(xy)yyxyxxxy
xyyx(yxyx)yyyxxxxy = xyyx(xyxy)yyyxxxxy
xyyx(yx)yxyyyxxxxy = xyyx(xy)yxyyyxxxxy
xyyx(yxyxy)yyxxxxy = xyyx(xyyyx)yyxxxxy
xyyxyx(yx)yyyxxxxy = xyyxyx(xy)yyyxxxxy
xyyx(yx)yyxxxxxyyy = xyyx(xy)yyxxxxxyyy
xyyx(yx)yyxxxxyxyy = xyyx(xy)yyxxxxyxyy
xyyx(yx)yyxxxxyyxy = xyyx(xy)yyxxxxyyxy
xyyx(yx)yyxxxxyyyx = xyyx(xy)yyxxxxyyyx
xyyx(yx)yyxxxyxxyy = xyyx(xy)yyxxxyxxyy
xyyx(yx)yyxxxyxyxy = xyyx(xy)yyxxxyxyxy
xyyx(yxyyxxxy)xyxy = xyyx(xyyyxxyx)xyxy
xyyx(yx)yyxxxyxyyx = xyyx(xy)yyxxxyxyyx
xyyx(yxyyxxxy)xyyx = xyyx(xyyyxxyx)xyyx
xyyx(yx)yyxxxyyxxy = xyyx(xy)yyxxxyyxxy
xyyx(yxyyxxxy)yxxy = xyyx(xyyyxxyx)yxxy
xyyx(yx)yyxxxyyxyx = xyyx(xy)yyxxxyyxyx
xyyx(yx)yyxxxyyyxx = xyyx(xy)yyxxxyyyxx
xyyx(yx)yyxxyxxxyy = xyyx(xy)yyxxyxxxyy
xyyx(yxyyxxyx)xyxy = xyyx(xyyyxxxy)xyxy
xyyx(yx)yyxxyxxyxy = xyyx(xy)yyxxyxxyxy
xyyxyxyyxx(yx)xyxy = xyyxyxyyxx(xy)xyxy
xyyx(yxyyxxyx)xyyx = xyyx(xyyyxxxy)xyyx
xyyx(yx)yyxxyxxyyx = xyyx(xy)yyxxyxxyyx
xyyxyxyyxx(yx)xyyx = xyyxyxyyxx(xy)xyyx
xyyx(yxyyxxyx)yxxy = xyyx(xyyyxxxy)yxxy
xyyx(yx)yyxxyxyxxy = xyyx(xy)yyxxyxyxxy
xyyxyxyyxx(yx)yxxy = xyyxyxyyxx(xy)yxxy
xyyx(yx)yyxxyyxxxy = xyyx(xy)yyxxyyxxxy
xyyx(yxyyxxy)yxxxy = xyyx(xyyyxyx)yxxxy
xyyxyxy(yx)xyyyxxx = xyyxyxy(xy)xyyyxxx
xyyx(yx)yyxyxxxxyy = xyyx(xy)yyxyxxxxyy
xyyx(yx)yyxyxxxyxy = xyyx(xy)yyxyxxxyxy
xyyx(yx)yyxyxxxyyx = xyyx(xy)yyxyxxxyyx
xyyx(yx)yyxyxxyxxy = xyyx(xy)yyxyxxyxxy
xyyxyxyyx(yx)xyyxx = xyyxyxyyx(xy)xyyxx
xyyx(yxyyxyx)yxxxy = xyyx(xyyyxxy)yxxxy
xyyx(yx)yyxyxyxxxy = xyyx(xy)yyxyxyxxxy
xyyxyxyyx(yx)yxxxy = xyyxyxyyx(xy)yxxxy
xyyxyxyyx(yx)yxxyx = xyyxyxyyx(xy)yxxyx
xyyx(yxyyx)yyxxxxy = xyyx(xyxyy)yyxxxxy
xyyx(yxyyx)yyxxxxy = xyyx(xyyxy)yyxxxxy
xyyx(yx)yyxyyxxxxy = xyyx(xy)yyxyyxxxxy
xyyxyx(yyx)yyxxxxy = xyyxyx(xyy)yyxxxxy
xyyxyxy(yx)yyxxxxy = xyyxyxy(xy)yyxxxxy
xyyxyxy(yx)yyxxxyx = xyyxyxy(xy)yyxxxyx
xyyx(yx)yyyxxxxxyy = xyyx(xy)yyyxxxxxyy
xyyx(yx)yyyxxxxyxy = xyyx(xy)yyyxxxxyxy
xyyx(yx)yyyxxxxyyx = xyyx(xy)yyyxxxxyyx
xyyx(yx)yyyxxxyxxy = xyyx(xy)yyyxxxyxxy
xyyx(yx)yyyxxyxxxy = xyyx(xy)yyyxxyxxxy
xyyxyxyyyxx(yx)xyx = xyyxyxyyyxx(xy)xyx
xyyx(yx)yyyxyxxxxy = xyyx(xy)yyyxyxxxxy
xyyx(yx)yyyyxxxxxy = xyyx(xy)yyyyxxxxxy
xyyxyyxxxy(yx)xyyx = xyyxyyxxxy(xy)xyyx
xyyxyyxxxy(yx)yxxy = xyyxyyxxxy(xy)yxxy
xyyxyyxx(yx)xxyyxy = xyyxyyxx(xy)xxyyxy
xyyxyyxx(yx)xxyyyx = xyyxyyxx(xy)xxyyyx
xyyxyyxx(yx)xyxxyy = xyyxyyxx(xy)xyxxyy
xyyxyyxx(yx)xyxyxy = xyyxyyxx(xy)xyxyxy
xyyxyyxx(yx)xyxyyx = xyyxyyxx(xy)xyxyyx
xyyxyyxx(yxxy)xyyx = xyyxyyxx(xyyx)xyyx
xyyxyyxx(yx)xyyxxy = xyyxyyxx(xy)xyyxxy
xyyxyyxx(yxxy)yxxy = xyyxyyxx(xyyx)yxxy
xyyxyyxx(yx)xyyxyx = xyyxyyxx(xy)xyyxyx
xyyxyyxx(yx)xyyyxx = xyyxyyxx(xy)xyyyxx
xyyxyyxx(yx)yxxxyy = xyyxyyxx(xy)yxxxyy
xyyxyyxx(yx)yxxyxy = xyyxyyxx(xy)yxxyxy
xyyxyyxx(yxyx)xyyx = xyyxyyxx(xyxy)xyyx
xyyxyyxx(yx)yxxyyx = xyyxyyxx(xy)yxxyyx
xyyxyyxxyx(yx)xyyx = xyyxyyxxyx(xy)xyyx
xyyxyyxx(yxyx)yxxy = xyyxyyxx(xyxy)yxxy
xyyxyyxx(yx)yxyxxy = xyyxyyxx(xy)yxyxxy
xyyxyyxxyx(yx)yxxy = xyyxyyxxyx(xy)yxxy
xyyxyyxx(yx)yyxxxy = xyyxyyxx(xy)yyxxxy
xyyxyyxxy(yx)xyyxx = xyyxyyxxy(xy)xyyxx
xyyxyyxx(yyx)yxxxy = xyyxyyxx(xyy)yxxxy
xyyxyyxxy(yx)yxxxy = xyyxyyxxy(xy)yxxxy
xyyxyyxxy(yx)yxxyx = xyyxyyxxy(xy)yxxyx
xyyxy(yx)xyyyyxxxx = xyyxy(xy)xyyyyxxxx
xyyxyyx(yxx)xyyyxx = xyyxyyx(xxy)xyyyxx
xyyxyyx(yx)xxyyyxx = xyyxyyx(xy)xxyyyxx
xyyxyyxyxx(yx)xyxy = xyyxyyxyxx(xy)xyxy
xyyxyyxyxx(yx)xyyx = xyyxyyxyxx(xy)xyyx
xyyxyyxyxx(yx)yxxy = xyyxyyxyxx(xy)yxxy
xyyxyyx(yx)xyxyyxx = xyyxyyx(xy)xyxyyxx
xyyxyyx(yxxy)xyyxx = xyyxyyx(xyyx)xyyxx
xyyxyyx(yxx)yyxxxy = xyyxyyx(xxy)yyxxxy
xyyxyyx(yx)xyyxxxy = xyyxyyx(xy)xyyxxxy
xyyxyyx(yxxy)yxxxy = xyyxyyx(xyyx)yxxxy
xyyxyyx(yx)xyyxxyx = xyyxyyx(xy)xyyxxyx
xyyxyyx(yxxy)yxxyx = xyyxyyx(xyyx)yxxyx
xyyxyyx(yx)xyyxyxx = xyyxyyx(xy)xyyxyxx
xyyxyyx(yx)xyyyxxx = xyyxyyx(xy)xyyyxxx
xyyxyyx(yx)yxxxxyy = xyyxyyx(xy)yxxxxyy
xyyxyyx(yx)yxxxyxy = xyyxyyx(xy)yxxxyxy
xyyxyyx(yx)yxxxyyx = xyyxyyx(xy)yxxxyyx
xyyxyyx(yx)yxxyxxy = xyyxyyx(xy)yxxyxxy
xyyxyyx(yx)yxxyxyx = xyyxyyx(xy)yxxyxyx
xyyxyyx(yxyx)xyyxx = xyyxyyx(xyxy)xyyxx
xyyxyyx(yx)yxxyyxx = xyyxyyx(xy)yxxyyxx
xyyxyyxyx(yx)xyyxx = xyyxyyxyx(xy)xyyxx
xyyxyyx(yxyx)yxxxy = xyyxyyx(xxyy)yxxxy
xyyxyyx(yxyx)yxxxy = xyyxyyx(xyxy)yxxxy
xyyxyyx(yx)yxyxxxy = xyyxyyx(xy)yxyxxxy
xyyxyyxyx(yx)yxxxy = xyyxyyxyx(xy)yxxxy
xyyxyyx(yxyx)yxxyx = xyyxyyx(xyxy)yxxyx
xyyxyyx(yx)yxyxxyx = xyyxyyx(xy)yxyxxyx
xyyxyyxyx(yx)yxxyx = xyyxyyxyx(xy)yxxyx
xyyxyyx(yx)yyxxxxy = xyyxyyx(xy)yyxxxxy
xyyxyyx(yx)yyxxxyx = xyyxyyx(xy)yyxxxyx
xyyx(yyx)yyxxxxxyy = xyyx(xyy)yyxxxxxyy
xyyxy(yx)yyxxxxxyy = xyyxy(xy)yyxxxxxyy
xyyx(yyx)yyxxxxyxy = xyyx(xyy)yyxxxxyxy
xyyxy(yx)yyxxxxyxy = xyyxy(xy)yyxxxxyxy
xyyx(yyx)yyxxxxyyx = xyyx(xyy)yyxxxxyyx
xyyxy(yx)yyxxxxyyx = xyyxy(xy)yyxxxxyyx
xyyx(yyx)yyxxxyxxy = xyyx(xyy)yyxxxyxxy
xyyxy(yx)yyxxxyxxy = xyyxy(xy)yyxxxyxxy
xyyxy(yx)yyxxxyxyx = xyyxy(xy)yyxxxyxyx
xyyxy(yxyyxxxy)xyx = xyyxy(xyyyxxyx)xyx
xyyxy(yx)yyxxxyyxx = xyyxy(xy)yyxxxyyxx
xyyx(yyx)yyxxyxxxy = xyyx(xyy)yyxxyxxxy
xyyxy(yx)yyxxyxxxy = xyyxy(xy)yyxxyxxxy
xyyxy(yxyyxxyx)xyx = xyyxy(xyyyxxxy)xyx
xyyxy(yx)yyxxyxxyx = xyyxy(xy)yyxxyxxyx
xyyxyyxyyxx(yx)xyx = xyyxyyxyyxx(xy)xyx
xyyxy(yx)yyxxyxyxx = xyyxy(xy)yyxxyxyxx
xyyxy(yx)yyxxyyxxx = xyyxy(xy)yyxxyyxxx
xyyx(yyx)yyxyxxxxy = xyyx(xyy)yyxyxxxxy
xyyxy(yx)yyxyxxxxy = xyyxy(xy)yyxyxxxxy
xyyxy(yx)yyxyxxxyx = xyyxy(xy)yyxyxxxyx
xyyxy(yx)yyxyxxyxx = xyyxy(xy)yyxyxxyxx
xyyx(yyx)yyyxxxxxy = xyyx(xyy)yyyxxxxxy
xyyxy(yx)yyyxxxxxy = xyyxy(xy)yyyxxxxxy
xyyxy(yx)yyyxxxxyx = xyyxy(xy)yyyxxxxyx
xyyxy(yx)yyyxxxyxx = xyyxy(xy)yyyxxxyxx
xyyxyyyxxx(yx)xyxy = xyyxyyyxxx(xy)xyxy
xyyxyyyxxx(yx)xyyx = xyyxyyyxxx(xy)xyyx
xyyxyyyxxx(yx)yxxy = xyyxyyyxxx(xy)yxxy
xyyxyyyxx(yxx)xyyx = xyyxyyyxx(xxy)xyyx
xyyxyyyxx(yx)xxyyx = xyyxyyyxx(xy)xxyyx
xyyxyyyxx(yxx)yxxy = xyyxyyyxx(xxy)yxxy
xyyxyyyxx(yx)xyxxy = xyyxyyyxx(xy)xyxxy
xyyxyyyxx(yx)xyxyx = xyyxyyyxx(xy)xyxyx
xyyxyyyxx(yx)xyyxx = xyyxyyyxx(xy)xyyxx
xyyxyyyxx(yx)yxxxy = xyyxyyyxx(xy)yxxxy
xyyxyyyxx(yx)yxxyx = xyyxyyyxx(xy)yxxyx
xyyxyyyxyxx(yx)xyx = xyyxyyyxyxx(xy)xyx
xyyxyyyx(yx)xyyxxx = xyyxyyyx(xy)xyyxxx
xyyxyyyx(yx)yxxxxy = xyyxyyyx(xy)yxxxxy
xyyxyyyx(yx)yxxxyx = xyyxyyyx(xy)yxxxyx
xyyxyyyx(yx)yxxyxx = xyyxyyyx(xy)yxxyxx
xyyxyyyyxxx(yx)xyx = xyyxyyyyxxx(xy)xyx
xyyxyyyyxx(yx)xyxx = xyyxyyyyxx(xy)xyxx
xyyyxxxxxyy(yx)yxy = xyyyxxxxxyy(xy)yxy
xyyyxxxxy(yx)xyxyy = xyyyxxxxy(xy)xyxyy
xyyyxxxxy(yx)xyyxy = xyyyxxxxy(xy)xyyxy
xyyyxxxxy(yx)xyyyx = xyyyxxxxy(xy)xyyyx
xyyyxxxxy(yx)yxxyy = xyyyxxxxy(xy)yxxyy
xyyyxxxxyy(yx)xyyx = xyyyxxxxyy(xy)xyyx
xyyyxxxxyy(yx)yxxy = xyyyxxxxyy(xy)yxxy
xyyyxxxxyy(yx)yxyx = xyyyxxxxyy(xy)yxyx
xyyyxxx(yx)xxyxyyy = xyyyxxx(xy)xxyxyyy
xyyyxxx(yx)xxyyxyy = xyyyxxx(xy)xxyyxyy
xyyyxxx(yx)xxyyyxy = xyyyxxx(xy)xxyyyxy
xyyyxxx(yx)xxyyyyx = xyyyxxx(xy)xxyyyyx
xyyyxxx(yx)xyxxyyy = xyyyxxx(xy)xyxxyyy
xyyyxxx(yx)yxxxyyy = xyyyxxx(xy)yxxxyyy
xyyyxxxyxy(yx)xyyx = xyyyxxxyxy(xy)xyyx
xyyyxxxyxy(yx)yxxy = xyyyxxxyxy(xy)yxxy
xyyyxxxy(yx)xxyyxy = xyyyxxxy(xy)xxyyxy
xyyyxxxy(yx)xxyyyx = xyyyxxxy(xy)xxyyyx
xyyyxxxy(yx)xyxyxy = xyyyxxxy(xy)xyxyxy
xyyyxxxy(yx)xyxyyx = xyyyxxxy(xy)xyxyyx
xyyyxxxy(yxxy)xyyx = xyyyxxxy(xyyx)xyyx
xyyyxxxy(yx)xyyxxy = xyyyxxxy(xy)xyyxxy
xyyyxxxy(yxxy)yxxy = xyyyxxxy(xyyx)yxxy
xyyyxxxy(yx)xyyxyx = xyyyxxxy(xy)xyyxyx
xyyyxxxy(yx)xyyyxx = xyyyxxxy(xy)xyyyxx
xyyyxxxy(yx)yxxxyy = xyyyxxxy(xy)yxxxyy
xyyyxxxy(yx)yxxyxy = xyyyxxxy(xy)yxxyxy
xyyyxxxy(yxyx)xyyx = xyyyxxxy(xyxy)xyyx
xyyyxxxy(yx)yxxyyx = xyyyxxxy(xy)yxxyyx
xyyyxxxyyx(yx)xyyx = xyyyxxxyyx(xy)xyyx
xyyyxxxy(yxyx)yxxy = xyyyxxxy(xyxy)yxxy
xyyyxxxy(yx)yxyxxy = xyyyxxxy(xy)yxyxxy
xyyyxxxyyx(yx)yxxy = xyyyxxxyyx(xy)yxxy
xyyyxxxy(yx)yyxxxy = xyyyxxxy(xy)yyxxxy
xyyyxxxyy(yx)xyyxx = xyyyxxxyy(xy)xyyxx
xyyyxxxy(yyx)yxxxy = xyyyxxxy(xyy)yxxxy
xyyyxxxyy(yx)yxxxy = xyyyxxxyy(xy)yxxxy
xyyyxxxyy(yx)yxxyx = xyyyxxxyy(xy)yxxyx
xyyyxxxyy(yx)yxyxx = xyyyxxxyy(xy)yxyxx
xyyyxx(yxx)xxyyxyy = xyyyxx(xxy)xxyyxyy
xyyyxx(yx)xxxyyxyy = xyyyxx(xy)xxxyyxyy
xyyyxx(yxx)xxyyyxy = xyyyxx(xxy)xxyyyxy
xyyyxx(yx)xxxyyyxy = xyyyxx(xy)xxxyyyxy
xyyyxx(yxx)xxyyyyx = xyyyxx(xxy)xxyyyyx
xyyyxx(yx)xxxyyyyx = xyyyxx(xy)xxxyyyyx
xyyyxx(yx)xxyxyxyy = xyyyxx(xy)xxyxyxyy
xyyyxx(yx)xxyxyyxy = xyyyxx(xy)xxyxyyxy
xyyyxx(yx)xxyxyyyx = xyyyxx(xy)xxyxyyyx
xyyyxx(yx)xxyyxxyy = xyyyxx(xy)xxyyxxyy
xyyyxx(yx)xxyyxyxy = xyyyxx(xy)xxyyxyxy
xyyyxx(yx)xxyyxyyx = xyyyxx(xy)xxyyxyyx
xyyyxx(yx)xxyyyxxy = xyyyxx(xy)xxyyyxxy
xyyyxx(yx)xxyyyxyx = xyyyxx(xy)xxyyyxyx
xyyyxx(yx)xxyyyyxx = xyyyxx(xy)xxyyyyxx
xyyyxx(yxx)yxxxyyy = xyyyxx(xxy)yxxxyyy
xyyyxx(yx)xyxxxyyy = xyyyxx(xy)xyxxxyyy
xyyyxx(yx)xyxxyxyy = xyyyxx(xy)xyxxyxyy
xyyyxx(yx)xyxxyyxy = xyyyxx(xy)xyxxyyxy
xyyyxx(yxxy)xxyyxy = xyyyxx(xyyx)xxyyxy
xyyyxx(yx)xyxxyyyx = xyyyxx(xy)xyxxyyyx
xyyyxx(yxxy)xxyyyx = xyyyxx(xyyx)xxyyyx
xyyyxx(yx)xyxyxxyy = xyyyxx(xy)xyxyxxyy
xyyyxx(yx)xyxyxyxy = xyyyxx(xy)xyxyxyxy
xyyyxx(yxxy)xyxyxy = xyyyxx(xyyx)xyxyxy
xyyyxx(yx)xyxyxyyx = xyyyxx(xy)xyxyxyyx
xyyyxx(yxxyxy)xyyx = xyyyxx(xyxyyx)xyyx
xyyyxx(yxxy)xyxyyx = xyyyxx(xyyx)xyxyyx
xyyyxx(yxxyxy)xyyx = xyyyxx(xyyxyx)xyyx
xyyyxx(yx)xyxyyxxy = xyyyxx(xy)xyxyyxxy
xyyyxx(yxxyxy)yxxy = xyyyxx(xyxyyx)yxxy
xyyyxx(yxxy)xyyxxy = xyyyxx(xyyx)xyyxxy
xyyyxx(yxxyxy)yxxy = xyyyxx(xyyxyx)yxxy
xyyyxx(yx)xyxyyxyx = xyyyxx(xy)xyxyyxyx
xyyyxx(yxxy)xyyxyx = xyyyxx(xyyx)xyyxyx
xyyyxx(yx)xyxyyyxx = xyyyxx(xy)xyxyyyxx
xyyyxx(yxxy)xyyyxx = xyyyxx(xyyx)xyyyxx
xyyyxx(yx)xyyxxxyy = xyyyxx(xy)xyyxxxyy
xyyyxx(yxxy)yxxxyy = xyyyxx(xyyx)yxxxyy
xyyyxx(yx)xyyxxyxy = xyyyxx(xy)xyyxxyxy
xyyyxx(yxxy)yxxyxy = xyyyxx(xyyx)yxxyxy
xyyyxx(yxxyyx)xyyx = xyyyxx(xyxyxy)xyyx
xyyyxx(yx)xyyxxyyx = xyyyxx(xy)xyyxxyyx
xyyyxx(yxxyyx)xyyx = xyyyxx(xyyxxy)xyyx
xyyyxx(yxxy)yxxyyx = xyyyxx(xyyx)yxxyyx
xyyyxxyxxy(yx)xyyx = xyyyxxyxxy(xy)xyyx
xyyyxx(yxxyyx)yxxy = xyyyxx(xyxyxy)yxxy
xyyyxx(yx)xyyxyxxy = xyyyxx(xy)xyyxyxxy
xyyyxx(yxxyyx)yxxy = xyyyxx(xyyxxy)yxxy
xyyyxx(yxxy)yxyxxy = xyyyxx(xyyx)yxyxxy
xyyyxxyxxy(yx)yxxy = xyyyxxyxxy(xy)yxxy
xyyyxx(yx)xyyxyxyx = xyyyxx(xy)xyyxyxyx
xyyyxx(yx)xyyxyyxx = xyyyxx(xy)xyyxyyxx
xyyyxx(yx)xyyyxxxy = xyyyxx(xy)xyyyxxxy
xyyyxx(yxxy)yyxxxy = xyyyxx(xyyx)yyxxxy
xyyyxx(yxxyy)yxxxy = xyyyxx(xyyyx)yxxxy
xyyyxx(yx)xyyyxxyx = xyyyxx(xy)xyyyxxyx
xyyyxx(yx)xyyyxyxx = xyyyxx(xy)xyyyxyxx
xyyyxx(yx)xyyyyxxx = xyyyxx(xy)xyyyyxxx
xyyyxx(yx)yxxxxyyy = xyyyxx(xy)yxxxxyyy
xyyyxx(yx)yxxxyxyy = xyyyxx(xy)yxxxyxyy
xyyyxx(yxyx)xxyyxy = xyyyxx(xyxy)xxyyxy
xyyyxx(yx)yxxxyyxy = xyyyxx(xy)yxxxyyxy
xyyyxxyx(yx)xxyyxy = xyyyxxyx(xy)xxyyxy
xyyyxx(yxyx)xxyyyx = xyyyxx(xyxy)xxyyyx
xyyyxx(yx)yxxxyyyx = xyyyxx(xy)yxxxyyyx
xyyyxxyx(yx)xxyyyx = xyyyxxyx(xy)xxyyyx
xyyyxx(yx)yxxyxxyy = xyyyxx(xy)yxxyxxyy
xyyyxx(yxyx)xyxyxy = xyyyxx(xyxy)xyxyxy
xyyyxx(yx)yxxyxyxy = xyyyxx(xy)yxxyxyxy
xyyyxxyx(yx)xyxyxy = xyyyxxyx(xy)xyxyxy
xyyyxx(yxyx)xyxyyx = xyyyxx(xyxy)xyxyyx
xyyyxx(yxyxxy)xyyx = xyyyxx(xyxyyx)xyyx
xyyyxx(yx)yxxyxyyx = xyyyxx(xy)yxxyxyyx
xyyyxx(yxyxxy)xyyx = xyyyxx(xyyxyx)xyyx
xyyyxxyx(yx)xyxyyx = xyyyxxyx(xy)xyxyyx
xyyyxxyx(yxxy)xyyx = xyyyxxyx(xyyx)xyyx
xyyyxx(yxyx)xyyxxy = xyyyxx(xyxy)xyyxxy
xyyyxx(yxyxxy)yxxy = xyyyxx(xyxyyx)yxxy
xyyyxx(yx)yxxyyxxy = xyyyxx(xy)yxxyyxxy
xyyyxx(yxyxxy)yxxy = xyyyxx(xyyxyx)yxxy
xyyyxxyx(yx)xyyxxy = xyyyxxyx(xy)xyyxxy
xyyyxxyx(yxxy)yxxy = xyyyxxyx(xyyx)yxxy
xyyyxx(yxyx)xyyxyx = xyyyxx(xyxy)xyyxyx
xyyyxx(yx)yxxyyxyx = xyyyxx(xy)yxxyyxyx
xyyyxxyx(yx)xyyxyx = xyyyxxyx(xy)xyyxyx
xyyyxx(yxyx)xyyyxx = xyyyxx(xyxy)xyyyxx
xyyyxx(yx)yxxyyyxx = xyyyxx(xy)yxxyyyxx
xyyyxxyx(yx)xyyyxx = xyyyxxyx(xy)xyyyxx
xyyyxx(yxyx)yxxxyy = xyyyxx(xyxy)yxxxyy
xyyyxx(yx)yxyxxxyy = xyyyxx(xy)yxyxxxyy
xyyyxxyx(yx)yxxxyy = xyyyxxyx(xy)yxxxyy
xyyyxx(yxyx)yxxyxy = xyyyxx(xyxy)yxxyxy
xyyyxx(yx)yxyxxyxy = xyyyxx(xy)yxyxxyxy
xyyyxxyx(yx)yxxyxy = xyyyxxyx(xy)yxxyxy
xyyyxx(yxyxyx)xyyx = xyyyxx(xyxyxy)xyyx
xyyyxx(yxyx)yxxyyx = xyyyxx(xyxy)yxxyyx
xyyyxx(yxyxyx)xyyx = xyyyxx(xyyxxy)xyyx
xyyyxx(yx)yxyxxyyx = xyyyxx(xy)yxyxxyyx
xyyyxxyx(yxyx)xyyx = xyyyxxyx(xyxy)xyyx
xyyyxxyx(yx)yxxyyx = xyyyxxyx(xy)yxxyyx
xyyyxxyxyx(yx)xyyx = xyyyxxyxyx(xy)xyyx
xyyyxx(yxyxyx)yxxy = xyyyxx(xyxyxy)yxxy
xyyyxx(yxyx)yxyxxy = xyyyxx(xyxy)yxyxxy
xyyyxx(yxyxyx)yxxy = xyyyxx(xyyxxy)yxxy
xyyyxx(yx)yxyxyxxy = xyyyxx(xy)yxyxyxxy
xyyyxxyx(yxyx)yxxy = xyyyxxyx(xyxy)yxxy
xyyyxxyx(yx)yxyxxy = xyyyxxyx(xy)yxyxxy
xyyyxxyxyx(yx)yxxy = xyyyxxyxyx(xy)yxxy
xyyyxx(yxyx)yyxxxy = xyyyxx(xyxy)yyxxxy
xyyyxx(yx)yxyyxxxy = xyyyxx(xy)yxyyxxxy
xyyyxx(yxyxy)yxxxy = xyyyxx(xyyyx)yxxxy
xyyyxxyx(yx)yyxxxy = xyyyxxyx(xy)yyxxxy
xyyyxx(yx)yyxxxxyy = xyyyxx(xy)yyxxxxyy
xyyyxx(yx)yyxxxyxy = xyyyxx(xy)yyxxxyxy
xyyyxx(yx)yyxxxyyx = xyyyxx(xy)yyxxxyyx
xyyyxx(yx)yyxxyxxy = xyyyxx(xy)yyxxyxxy
xyyyxxyxy(yx)xyyxx = xyyyxxyxy(xy)xyyxx
xyyyxx(yxyyx)yxxxy = xyyyxx(xyxyy)yxxxy
xyyyxx(yxyyx)yxxxy = xyyyxx(xyyxy)yxxxy
xyyyxx(yx)yyxyxxxy = xyyyxx(xy)yyxyxxxy
xyyyxxyx(yyx)yxxxy = xyyyxxyx(xyy)yxxxy
xyyyxxyxy(yx)yxxxy = xyyyxxyxy(xy)yxxxy
xyyyxxyxy(yx)yxxyx = xyyyxxyxy(xy)yxxyx
xyyyxx(yx)yyyxxxxy = xyyyxx(xy)yyyxxxxy
xyyyxx(yyxx)xyyyxx = xyyyxx(xyxy)xyyyxx
xyyyxx(yyx)xxyyyxx = xyyyxx(xyy)xxyyyxx
xyyyxxy(yxx)xyyyxx = xyyyxxy(xxy)xyyyxx
xyyyxxy(yx)xxyyyxx = xyyyxxy(xy)xxyyyxx
xyyyxxyyxx(yx)xyxy = xyyyxxyyxx(xy)xyxy
xyyyxxyyxx(yx)xyyx = xyyyxxyyxx(xy)xyyx
xyyyxxyyxx(yx)yxxy = xyyyxxyyxx(xy)yxxy
xyyyxxy(yx)xyxyyxx = xyyyxxy(xy)xyxyyxx
xyyyxxy(yxxy)xyyxx = xyyyxxy(xyyx)xyyxx
xyyyxx(yyxx)yyxxxy = xyyyxx(xyxy)yyxxxy
xyyyxx(yyx)xyyxxxy = xyyyxx(xyy)xyyxxxy
xyyyxx(yyxxy)yxxxy = xyyyxx(xyyyx)yxxxy
xyyyxxy(yxx)yyxxxy = xyyyxxy(xxy)yyxxxy
xyyyxxy(yx)xyyxxxy = xyyyxxy(xy)xyyxxxy
xyyyxxy(yxxy)yxxxy = xyyyxxy(xyyx)yxxxy
xyyyxxy(yx)xyyxxyx = xyyyxxy(xy)xyyxxyx
xyyyxxy(yxxy)yxxyx = xyyyxxy(xyyx)yxxyx
xyyyxxy(yx)xyyxyxx = xyyyxxy(xy)xyyxyxx
xyyyxxy(yx)xyyyxxx = xyyyxxy(xy)xyyyxxx
xyyyxx(yyx)yxxxxyy = xyyyxx(xyy)yxxxxyy
xyyyxxy(yx)yxxxxyy = xyyyxxy(xy)yxxxxyy
xyyyxx(yyx)yxxxyxy = xyyyxx(xyy)yxxxyxy
xyyyxxy(yx)yxxxyxy = xyyyxxy(xy)yxxxyxy
xyyyxx(yyx)yxxxyyx = xyyyxx(xyy)yxxxyyx
xyyyxxy(yx)yxxxyyx = xyyyxxy(xy)yxxxyyx
xyyyxx(yyx)yxxyxxy = xyyyxx(xyy)yxxyxxy
xyyyxxy(yx)yxxyxxy = xyyyxxy(xy)yxxyxxy
xyyyxxy(yx)yxxyxyx = xyyyxxy(xy)yxxyxyx
xyyyxxy(yxyx)xyyxx = xyyyxxy(xyxy)xyyxx
xyyyxxy(yx)yxxyyxx = xyyyxxy(xy)yxxyyxx
xyyyxxyyx(yx)xyyxx = xyyyxxyyx(xy)xyyxx
xyyyxx(yyxyx)yxxxy = xyyyxx(xyxyy)yxxxy
xyyyxx(yyxyx)yxxxy = xyyyxx(xyyxy)yxxxy
xyyyxx(yyx)yxyxxxy = xyyyxx(xyy)yxyxxxy
xyyyxxy(yxyx)yxxxy = xyyyxxy(xxyy)yxxxy
xyyyxxy(yxyx)yxxxy = xyyyxxy(xyxy)yxxxy
xyyyxxy(yx)yxyxxxy = xyyyxxy(xy)yxyxxxy
xyyyxxyyx(yx)yxxxy = xyyyxxyyx(xy)yxxxy
xyyyxxy(yxyx)yxxyx = xyyyxxy(xyxy)yxxyx
xyyyxxy(yx)yxyxxyx = xyyyxxy(xy)yxyxxyx
xyyyxxyyx(yx)yxxyx = xyyyxxyyx(xy)yxxyx
xyyyxx(yyx)yyxxxxy = xyyyxx(xyy)yyxxxxy
xyyyxxy(yx)yyxxxxy = xyyyxxy(xy)yyxxxxy
xyyyxxy(yx)yyxxxyx = xyyyxxy(xy)yyxxxyx
xyyyxxyyyxx(yx)xyx = xyyyxxyyyxx(xy)xyx
xyyyx(yxx)xxyyyyxx = xyyyx(xxy)xxyyyyxx
xyyyx(yx)xxxyyyyxx = xyyyx(xy)xxxyyyyxx
xyyyx(yxx)xyxyyyxx = xyyyx(xxy)xyxyyyxx
xyyyx(yxxxy)xyyyxx = xyyyx(xxyyx)xyyyxx
xyyyx(yx)xxyxyyyxx = xyyyx(xy)xxyxyyyxx
xyyyx(yxxxy)xyyyxx = xyyyx(xyxyx)xyyyxx
xyyyx(yxxxy)xyyyxx = xyyyx(xyyxx)xyyyxx
xyyyxyxxxy(yx)xyyx = xyyyxyxxxy(xy)xyyx
xyyyxyxxxy(yx)yxxy = xyyyxyxxxy(xy)yxxy
xyyyx(yxx)xyyxyyxx = xyyyx(xxy)xyyxyyxx
xyyyx(yx)xxyyxyyxx = xyyyx(xy)xxyyxyyxx
xyyyx(yxx)xyyyxxxy = xyyyx(xxy)xyyyxxxy
xyyyx(yxxxy)yyxxxy = xyyyx(xxyyx)yyxxxy
xyyyx(yxxxyy)yxxxy = xyyyx(xxyyyx)yxxxy
xyyyx(yx)xxyyyxxxy = xyyyx(xy)xxyyyxxxy
xyyyx(yxxxy)yyxxxy = xyyyx(xyxyx)yyxxxy
xyyyx(yxxxyy)yxxxy = xyyyx(xyxyyx)yxxxy
xyyyx(yxxxy)yyxxxy = xyyyx(xyyxx)yyxxxy
xyyyx(yxxxyy)yxxxy = xyyyx(xyyxyx)yxxxy
xyyyx(yxx)xyyyxxyx = xyyyx(xxy)xyyyxxyx
xyyyx(yx)xxyyyxxyx = xyyyx(xy)xxyyyxxyx
xyyyx(yxx)xyyyxyxx = xyyyx(xxy)xyyyxyxx
xyyyx(yx)xxyyyxyxx = xyyyx(xy)xxyyyxyxx
xyyyx(yxx)xyyyyxxx = xyyyx(xxy)xyyyyxxx
xyyyx(yx)xxyyyyxxx = xyyyx(xy)xxyyyyxxx
xyyyxyxx(yx)xxyyxy = xyyyxyxx(xy)xxyyxy
xyyyxyxx(yx)xxyyyx = xyyyxyxx(xy)xxyyyx
xyyyxyxx(yx)xyxxyy = xyyyxyxx(xy)xyxxyy
xyyyxyxx(yx)xyxyxy = xyyyxyxx(xy)xyxyxy
xyyyxyxx(yx)xyxyyx = xyyyxyxx(xy)xyxyyx
xyyyxyxx(yxxy)xyyx = xyyyxyxx(xyyx)xyyx
xyyyxyxx(yx)xyyxxy = xyyyxyxx(xy)xyyxxy
xyyyxyxx(yxxy)yxxy = xyyyxyxx(xyyx)yxxy
xyyyxyxx(yx)xyyxyx = xyyyxyxx(xy)xyyxyx
xyyyx(yxxyx)xyyyxx = xyyyx(xxyxy)xyyyxx
xyyyx(yxx)yxxyyyxx = xyyyx(xxy)yxxyyyxx
xyyyx(yxxyx)xyyyxx = xyyyx(xyxxy)xyyyxx
xyyyx(yx)xyxxyyyxx = xyyyx(xy)xyxxyyyxx
xyyyx(yxxy)xxyyyxx = xyyyx(xyyx)xxyyyxx
xyyyxyxx(yx)xyyyxx = xyyyxyxx(xy)xyyyxx
xyyyxyxx(yx)yxxxyy = xyyyxyxx(xy)yxxxyy
xyyyxyxx(yx)yxxyxy = xyyyxyxx(xy)yxxyxy
xyyyxyxx(yxyx)xyyx = xyyyxyxx(xyxy)xyyx
xyyyxyxx(yx)yxxyyx = xyyyxyxx(xy)yxxyyx
xyyyxyxxyx(yx)xyyx = xyyyxyxxyx(xy)xyyx
xyyyxyxx(yxyx)yxxy = xyyyxyxx(xyxy)yxxy
xyyyxyxx(yx)yxyxxy = xyyyxyxx(xy)yxyxxy
xyyyxyxxyx(yx)yxxy = xyyyxyxxyx(xy)yxxy
xyyyx(yx)xyxyxyyxx = xyyyx(xy)xyxyxyyxx
xyyyx(yxxyxy)xyyxx = xyyyx(xyxyyx)xyyxx
xyyyx(yxxy)xyxyyxx = xyyyx(xyyx)xyxyyxx
xyyyx(yxxyxy)xyyxx = xyyyx(xyyxyx)xyyxx
xyyyx(yxxyx)yyxxxy = xyyyx(xxyxy)yyxxxy
xyyyx(yxx)yxyyxxxy = xyyyx(xxy)yxyyxxxy
xyyyx(yxxyxy)yxxxy = xyyyx(xxyyyx)yxxxy
xyyyx(yxxyx)yyxxxy = xyyyx(xyxxy)yyxxxy
xyyyx(yx)xyxyyxxxy = xyyyx(xy)xyxyyxxxy
xyyyx(yxxyxy)yxxxy = xyyyx(xyxyyx)yxxxy
xyyyx(yxxy)xyyxxxy = xyyyx(xyyx)xyyxxxy
xyyyx(yxxyxy)yxxxy = xyyyx(xyyxyx)yxxxy
xyyyxyxx(yx)yyxxxy = xyyyxyxx(xy)yyxxxy
xyyyx(yx)xyxyyxxyx = xyyyx(xy)xyxyyxxyx
xyyyx(yxxyxy)yxxyx = xyyyx(xyxyyx)yxxyx
xyyyx(yxxy)xyyxxyx = xyyyx(xyyx)xyyxxyx
xyyyx(yxxyxy)yxxyx = xyyyx(xyyxyx)yxxyx
xyyyx(yx)xyxyyxyxx = xyyyx(xy)xyxyyxyxx
xyyyx(yxxy)xyyxyxx = xyyyx(xyyx)xyyxyxx
xyyyx(yx)xyxyyyxxx = xyyyx(xy)xyxyyyxxx
xyyyx(yxxy)xyyyxxx = xyyyx(xyyx)xyyyxxx
xyyyx(yxx)yyxxxxyy = xyyyx(xxy)yyxxxxyy
xyyyx(yx)xyyxxxxyy = xyyyx(xy)xyyxxxxyy
xyyyx(yxxy)yxxxxyy = xyyyx(xyyx)yxxxxyy
xyyyx(yxx)yyxxxyxy = xyyyx(xxy)yyxxxyxy
xyyyx(yx)xyyxxxyxy = xyyyx(xy)xyyxxxyxy
xyyyx(yxxy)yxxxyxy = xyyyx(xyyx)yxxxyxy
xyyyx(yxx)yyxxxyyx = xyyyx(xxy)yyxxxyyx
xyyyx(yx)xyyxxxyyx = xyyyx(xy)xyyxxxyyx
xyyyx(yxxy)yxxxyyx = xyyyx(xyyx)yxxxyyx
xyyyx(yxx)yyxxyxxy = xyyyx(xxy)yyxxyxxy
xyyyx(yx)xyyxxyxxy = xyyyx(xy)xyyxxyxxy
xyyyx(yxxy)yxxyxxy = xyyyx(xyyx)yxxyxxy
xyyyx(yx)xyyxxyxyx = xyyyx(xy)xyyxxyxyx
xyyyx(yxxy)yxxyxyx = xyyyx(xyyx)yxxyxyx
xyyyx(yxxyyx)xyyxx = xyyyx(xyxyxy)xyyxx
xyyyx(yx)xyyxxyyxx = xyyyx(xy)xyyxxyyxx
xyyyx(yxxyyx)xyyxx = xyyyx(xyyxxy)xyyxx
xyyyx(yxxy)yxxyyxx = xyyyx(xyyx)yxxyyxx
xyyyxyxxy(yx)xyyxx = xyyyxyxxy(xy)xyyxx
xyyyx(yxxyyx)yxxxy = xyyyx(xxyxyy)yxxxy
xyyyx(yxxyyx)yxxxy = xyyyx(xxyyxy)yxxxy
xyyyx(yxx)yyxyxxxy = xyyyx(xxy)yyxyxxxy
xyyyx(yxxyyx)yxxxy = xyyyx(xyxxyy)yxxxy
xyyyx(yxxyyx)yxxxy = xyyyx(xyxyxy)yxxxy
xyyyx(yx)xyyxyxxxy = xyyyx(xy)xyyxyxxxy
xyyyx(yxxyyx)yxxxy = xyyyx(xyyxxy)yxxxy
xyyyx(yxxy)yxyxxxy = xyyyx(xyyx)yxyxxxy
xyyyxyxx(yyx)yxxxy = xyyyxyxx(xyy)yxxxy
xyyyxyxxy(yx)yxxxy = xyyyxyxxy(xy)yxxxy
xyyyx(yxxyyx)yxxyx = xyyyx(xyxyxy)yxxyx
xyyyx(yx)xyyxyxxyx = xyyyx(xy)xyyxyxxyx
xyyyx(yxxyyx)yxxyx = xyyyx(xyyxxy)yxxyx
xyyyx(yxxy)yxyxxyx = xyyyx(xyyx)yxyxxyx
xyyyxyxxy(yx)yxxyx = xyyyxyxxy(xy)yxxyx
xyyyx(yx)xyyxyxyxx = xyyyx(xy)xyyxyxyxx
xyyyx(yx)xyyxyyxxx = xyyyx(xy)xyyxyyxxx
xyyyx(yxx)yyyxxxxy = xyyyx(xxy)yyyxxxxy
xyyyx(yx)xyyyxxxxy = xyyyx(xy)xyyyxxxxy
xyyyx(yxxy)yyxxxxy = xyyyx(xyyx)yyxxxxy
xyyyx(yx)xyyyxxxyx = xyyyx(xy)xyyyxxxyx
xyyyx(yxxy)yyxxxyx = xyyyx(xyyx)yyxxxyx
xyyyx(yx)xyyyxxyxx = xyyyx(xy)xyyyxxyxx
xyyyx(yx)xyyyxyxxx = xyyyx(xy)xyyyxyxxx
xyyyx(yx)xyyyyxxxx = xyyyx(xy)xyyyyxxxx
xyyyx(yx)yxxxxxyyy = xyyyx(xy)yxxxxxyyy
xyyyx(yx)yxxxxyxyy = xyyyx(xy)yxxxxyxyy
xyyyx(yx)yxxxxyyxy = xyyyx(xy)yxxxxyyxy
xyyyx(yx)yxxxxyyyx = xyyyx(xy)yxxxxyyyx
xyyyx(yx)yxxxyxxyy = xyyyx(xy)yxxxyxxyy
xyyyx(yx)yxxxyxyxy = xyyyx(xy)yxxxyxyxy
xyyyx(yxyxxxy)xyxy = xyyyx(xyyxxyx)xyxy
xyyyx(yx)yxxxyxyyx = xyyyx(xy)yxxxyxyyx
xyyyx(yxyxxxy)xyyx = xyyyx(xyyxxyx)xyyx
xyyyx(yx)yxxxyyxxy = xyyyx(xy)yxxxyyxxy
xyyyx(yxyxxxy)yxxy = xyyyx(xyyxxyx)yxxy
xyyyx(yx)yxxxyyxyx = xyyyx(xy)yxxxyyxyx
xyyyx(yxyxx)xyyyxx = xyyyx(xxyxy)xyyyxx
xyyyx(yxyx)xxyyyxx = xyyyx(xxyy)xxyyyxx
xyyyx(yxyxx)xyyyxx = xyyyx(xyxxy)xyyyxx
xyyyx(yxyx)xxyyyxx = xyyyx(xyxy)xxyyyxx
xyyyx(yx)yxxxyyyxx = xyyyx(xy)yxxxyyyxx
xyyyxyx(yxx)xyyyxx = xyyyxyx(xxy)xyyyxx
xyyyxyx(yx)xxyyyxx = xyyyxyx(xy)xxyyyxx
xyyyx(yx)yxxyxxxyy = xyyyx(xy)yxxyxxxyy
xyyyx(yxyxxyx)xyxy = xyyyx(xyyxxxy)xyxy
xyyyx(yx)yxxyxxyxy = xyyyx(xy)yxxyxxyxy
xyyyxyxyxx(yx)xyxy = xyyyxyxyxx(xy)xyxy
xyyyx(yxyxxyx)xyyx = xyyyx(xyyxxxy)xyyx
xyyyx(yx)yxxyxxyyx = xyyyx(xy)yxxyxxyyx
xyyyxyxyxx(yx)xyyx = xyyyxyxyxx(xy)xyyx
xyyyx(yxyxxyx)yxxy = xyyyx(xyyxxxy)yxxy
xyyyx(yx)yxxyxyxxy = xyyyx(xy)yxxyxyxxy
xyyyxyxyxx(yx)yxxy = xyyyxyxyxx(xy)yxxy
xyyyx(yx)yxxyxyxyx = xyyyx(xy)yxxyxyxyx
xyyyx(yxyx)xyxyyxx = xyyyx(xyxy)xyxyyxx
xyyyx(yxyxxy)xyyxx = xyyyx(xyxyyx)xyyxx
xyyyx(yx)yxxyxyyxx = xyyyx(xy)yxxyxyyxx
xyyyx(yxyxxy)xyyxx = xyyyx(xyyxyx)xyyxx
xyyyxyx(yx)xyxyyxx = xyyyxyx(xy)xyxyyxx
xyyyxyx(yxxy)xyyxx = xyyyxyx(xyyx)xyyxx
xyyyx(yxyxx)yyxxxy = xyyyx(xxyxy)yyxxxy
xyyyx(yxyx)xyyxxxy = xyyyx(xxyy)xyyxxxy
xyyyx(yxyxxy)yxxxy = xyyyx(xxyyyx)yxxxy
xyyyx(yxyxx)yyxxxy = xyyyx(xyxxy)yyxxxy
xyyyx(yxyx)xyyxxxy = xyyyx(xyxy)xyyxxxy
xyyyx(yxyxxy)yxxxy = xyyyx(xyxyyx)yxxxy
xyyyx(yx)yxxyyxxxy = xyyyx(xy)yxxyyxxxy
xyyyx(yxyxxy)yxxxy = xyyyx(xyyxyx)yxxxy
xyyyxyx(yxx)yyxxxy = xyyyxyx(xxy)yyxxxy
xyyyxyx(yx)xyyxxxy = xyyyxyx(xy)xyyxxxy
xyyyxyx(yxxy)yxxxy = xyyyxyx(xyyx)yxxxy
xyyyx(yxyx)xyyxxyx = xyyyx(xyxy)xyyxxyx
xyyyx(yxyxxy)yxxyx = xyyyx(xyxyyx)yxxyx
xyyyx(yx)yxxyyxxyx = xyyyx(xy)yxxyyxxyx
xyyyx(yxyxxy)yxxyx = xyyyx(xyyxyx)yxxyx
xyyyxyx(yx)xyyxxyx = xyyyxyx(xy)xyyxxyx
xyyyxyx(yxxy)yxxyx = xyyyxyx(xyyx)yxxyx
xyyyx(yxyx)xyyxyxx = xyyyx(xyxy)xyyxyxx
xyyyx(yx)yxxyyxyxx = xyyyx(xy)yxxyyxyxx
xyyyxyx(yx)xyyxyxx = xyyyxyx(xy)xyyxyxx
xyyyx(yxyx)xyyyxxx = xyyyx(xyxy)xyyyxxx
xyyyx(yx)yxxyyyxxx = xyyyx(xy)yxxyyyxxx
xyyyxyx(yx)xyyyxxx = xyyyxyx(xy)xyyyxxx
xyyyx(yxyx)yxxxxyy = xyyyx(xxyy)yxxxxyy
xyyyx(yxyx)yxxxxyy = xyyyx(xyxy)yxxxxyy
xyyyx(yx)yxyxxxxyy = xyyyx(xy)yxyxxxxyy
xyyyxyx(yx)yxxxxyy = xyyyxyx(xy)yxxxxyy
xyyyx(yxyx)yxxxyxy = xyyyx(xxyy)yxxxyxy
xyyyx(yxyx)yxxxyxy = xyyyx(xyxy)yxxxyxy
xyyyx(yx)yxyxxxyxy = xyyyx(xy)yxyxxxyxy
xyyyxyx(yx)yxxxyxy = xyyyxyx(xy)yxxxyxy
xyyyx(yxyx)yxxxyyx = xyyyx(xxyy)yxxxyyx
xyyyx(yxyx)yxxxyyx = xyyyx(xyxy)yxxxyyx
xyyyx(yx)yxyxxxyyx = xyyyx(xy)yxyxxxyyx
xyyyxyx(yx)yxxxyyx = xyyyxyx(xy)yxxxyyx
xyyyx(yxyx)yxxyxxy = xyyyx(xxyy)yxxyxxy
xyyyx(yxyx)yxxyxxy = xyyyx(xyxy)yxxyxxy
xyyyx(yx)yxyxxyxxy = xyyyx(xy)yxyxxyxxy
xyyyxyx(yx)yxxyxxy = xyyyxyx(xy)yxxyxxy
xyyyx(yxyx)yxxyxyx = xyyyx(xyxy)yxxyxyx
xyyyx(yx)yxyxxyxyx = xyyyx(xy)yxyxxyxyx
xyyyxyx(yx)yxxyxyx = xyyyxyx(xy)yxxyxyx
xyyyx(yxyxyx)xyyxx = xyyyx(xyxyxy)xyyxx
xyyyx(yxyx)yxxyyxx = xyyyx(xyxy)yxxyyxx
xyyyx(yxyxyx)xyyxx = xyyyx(xyyxxy)xyyxx
xyyyx(yx)yxyxxyyxx = xyyyx(xy)yxyxxyyxx
xyyyxyx(yxyx)xyyxx = xyyyxyx(xyxy)xyyxx
xyyyxyx(yx)yxxyyxx = xyyyxyx(xy)yxxyyxx
xyyyxyxyx(yx)xyyxx = xyyyxyxyx(xy)xyyxx
xyyyx(yxyxyx)yxxxy = xyyyx(xxyxyy)yxxxy
xyyyx(yxyxyx)yxxxy = xyyyx(xxyyxy)yxxxy
xyyyx(yxyx)yxyxxxy = xyyyx(xxyy)yxyxxxy
xyyyx(yxyxyx)yxxxy = xyyyx(xyxxyy)yxxxy
xyyyx(yxyxyx)yxxxy = xyyyx(xyxyxy)yxxxy
xyyyx(yxyx)yxyxxxy = xyyyx(xyxy)yxyxxxy
xyyyx(yxyxyx)yxxxy = xyyyx(xyyxxy)yxxxy
xyyyx(yx)yxyxyxxxy = xyyyx(xy)yxyxyxxxy
xyyyxyx(yxyx)yxxxy = xyyyxyx(xxyy)yxxxy
xyyyxyx(yxyx)yxxxy = xyyyxyx(xyxy)yxxxy
xyyyxyx(yx)yxyxxxy = xyyyxyx(xy)yxyxxxy
xyyyxyxyx(yx)yxxxy = xyyyxyxyx(xy)yxxxy
xyyyx(yxyxyx)yxxyx = xyyyx(xyxyxy)yxxyx
xyyyx(yxyx)yxyxxyx = xyyyx(xyxy)yxyxxyx
xyyyx(yxyxyx)yxxyx = xyyyx(xyyxxy)yxxyx
xyyyx(yx)yxyxyxxyx = xyyyx(xy)yxyxyxxyx
xyyyxyx(yxyx)yxxyx = xyyyxyx(xyxy)yxxyx
xyyyxyx(yx)yxyxxyx = xyyyxyx(xy)yxyxxyx
xyyyxyxyx(yx)yxxyx = xyyyxyxyx(xy)yxxyx
xyyyx(yx)yxyxyxyxx = xyyyx(xy)yxyxyxyxx
xyyyx(yx)yxyxyyxxx = xyyyx(xy)yxyxyyxxx
xyyyx(yxyx)yyxxxxy = xyyyx(xxyy)yyxxxxy
xyyyx(yxyx)yyxxxxy = xyyyx(xyxy)yyxxxxy
xyyyx(yx)yxyyxxxxy = xyyyx(xy)yxyyxxxxy
xyyyxyx(yx)yyxxxxy = xyyyxyx(xy)yyxxxxy
xyyyx(yxyx)yyxxxyx = xyyyx(xyxy)yyxxxyx
xyyyx(yx)yxyyxxxyx = xyyyx(xy)yxyyxxxyx
xyyyxyx(yx)yyxxxyx = xyyyxyx(xy)yyxxxyx
xyyyx(yx)yxyyxxyxx = xyyyx(xy)yxyyxxyxx
xyyyx(yx)yyxxxxxyy = xyyyx(xy)yyxxxxxyy
xyyyx(yx)yyxxxxyxy = xyyyx(xy)yyxxxxyxy
xyyyx(yx)yyxxxxyyx = xyyyx(xy)yyxxxxyyx
xyyyx(yx)yyxxxyxxy = xyyyx(xy)yyxxxyxxy
xyyyx(yx)yyxxxyxyx = xyyyx(xy)yyxxxyxyx
xyyyx(yxyyxxxy)xyx = xyyyx(xyyyxxyx)xyx
xyyyx(yx)yyxxxyyxx = xyyyx(xy)yyxxxyyxx
xyyyx(yx)yyxxyxxxy = xyyyx(xy)yyxxyxxxy
xyyyx(yxyyxxyx)xyx = xyyyx(xyyyxxxy)xyx
xyyyx(yx)yyxxyxxyx = xyyyx(xy)yyxxyxxyx
xyyyxyxyyxx(yx)xyx = xyyyxyxyyxx(xy)xyx
xyyyx(yx)yyxxyxyxx = xyyyx(xy)yyxxyxyxx
xyyyx(yx)yyxxyyxxx = xyyyx(xy)yyxxyyxxx
xyyyx(yx)yyxyxxxxy = xyyyx(xy)yyxyxxxxy
xyyyx(yx)yyxyxxxyx = xyyyx(xy)yyxyxxxyx
xyyyx(yx)yyxyxxyxx = xyyyx(xy)yyxyxxyxx
xyyyx(yx)yyyxxxxxy = xyyyx(xy)yyyxxxxxy
xyyyx(yx)yyyxxxxyx = xyyyx(xy)yyyxxxxyx
xyyyx(yx)yyyxxxyxx = xyyyx(xy)yyyxxxyxx
xyyyxyyxxx(yx)xyxy = xyyyxyyxxx(xy)xyxy
xyyyxyyxxx(yx)xyyx = xyyyxyyxxx(xy)xyyx
xyyyxyyxxx(yx)yxxy = xyyyxyyxxx(xy)yxxy
xyyyxyyxx(yxx)xyyx = xyyyxyyxx(xxy)xyyx
xyyyxyyxx(yx)xxyyx = xyyyxyyxx(xy)xxyyx
xyyyxyyxx(yxx)yxxy = xyyyxyyxx(xxy)yxxy
xyyyxyyxx(yx)xyxxy = xyyyxyyxx(xy)xyxxy
xyyyxyyxx(yx)xyxyx = xyyyxyyxx(xy)xyxyx
xyyyxyyxx(yx)xyyxx = xyyyxyyxx(xy)xyyxx
xyyyxyyxx(yx)yxxxy = xyyyxyyxx(xy)yxxxy
xyyyxyyxx(yx)yxxyx = xyyyxyyxx(xy)yxxyx
xyyyxyyxyxx(yx)xyx = xyyyxyyxyxx(xy)xyx
xyyyxyyx(yx)xyyxxx = xyyyxyyx(xy)xyyxxx
xyyyxyyx(yx)yxxxxy = xyyyxyyx(xy)yxxxxy
xyyyxyyx(yx)yxxxyx = xyyyxyyx(xy)yxxxyx
xyyyxyyx(yx)yxxyxx = xyyyxyyx(xy)yxxyxx
xyyyx(yyx)yyxxxxxy = xyyyx(xyy)yyxxxxxy
xyyyxy(yx)yyxxxxxy = xyyyxy(xy)yyxxxxxy
xyyyx(yyx)yyxxxxyx = xyyyx(xyy)yyxxxxyx
xyyyxy(yx)yyxxxxyx = xyyyxy(xy)yyxxxxyx
xyyyx(yyx)yyxxxyxx = xyyyx(xyy)yyxxxyxx
xyyyxy(yx)yyxxxyxx = xyyyxy(xy)yyxxxyxx
xyyyxy(yx)yyxxyxxx = xyyyxy(xy)yyxxyxxx
xyyyxyyyxxx(yx)xyx = xyyyxyyyxxx(xy)xyx
xyyyxyyyxx(yx)xyxx = xyyyxyyyxx(xy)xyxx
xyyyyxxxxy(yx)xyxy = xyyyyxxxxy(xy)xyxy
xyyyyxxxxy(yx)xyyx = xyyyyxxxxy(xy)xyyx
xyyyyxxxxy(yx)yxxy = xyyyyxxxxy(xy)yxxy
xyyyyxxx(yx)xxyxyy = xyyyyxxx(xy)xxyxyy
xyyyyxxx(yx)xxyyxy = xyyyyxxx(xy)xxyyxy
xyyyyxxx(yx)xxyyyx = xyyyyxxx(xy)xxyyyx
xyyyyxxx(yx)xyxxyy = xyyyyxxx(xy)xyxxyy
xyyyyxxx(yx)xyxyxy = xyyyyxxx(xy)xyxyxy
xyyyyxxx(yxxy)xyxy = xyyyyxxx(xyyx)xyxy
xyyyyxxx(yx)xyxyyx = xyyyyxxx(xy)xyxyyx
xyyyyxxx(yxxy)xyyx = xyyyyxxx(xyyx)xyyx
xyyyyxxx(yx)xyyxxy = xyyyyxxx(xy)xyyxxy
xyyyyxxx(yxxy)yxxy = xyyyyxxx(xyyx)yxxy
xyyyyxxx(yx)xyyxyx = xyyyyxxx(xy)xyyxyx
xyyyyxxx(yx)xyyyxx = xyyyyxxx(xy)xyyyxx
xyyyyxxx(yx)yxxxyy = xyyyyxxx(xy)yxxxyy
xyyyyxxx(yxyx)xyxy = xyyyyxxx(xyxy)xyxy
xyyyyxxx(yx)yxxyxy = xyyyyxxx(xy)yxxyxy
xyyyyxxxyx(yx)xyxy = xyyyyxxxyx(xy)xyxy
xyyyyxxx(yxyx)xyyx = xyyyyxxx(xyxy)xyyx
xyyyyxxx(yx)yxxyyx = xyyyyxxx(xy)yxxyyx
xyyyyxxxyx(yx)xyyx = xyyyyxxxyx(xy)xyyx
xyyyyxxx(yxyx)yxxy = xyyyyxxx(xyxy)yxxy
xyyyyxxx(yx)yxyxxy = xyyyyxxx(xy)yxyxxy
xyyyyxxxyx(yx)yxxy = xyyyyxxxyx(xy)yxxy
xyyyyxxx(yx)yyxxxy = xyyyyxxx(xy)yyxxxy
xyyyyxxx(yyxx)xyyx = xyyyyxxx(xyxy)xyyx
xyyyyxxx(yyx)xxyyx = xyyyyxxx(xyy)xxyyx
xyyyyxxxy(yxx)xyyx = xyyyyxxxy(xxy)xyyx
xyyyyxxxy(yx)xxyyx = xyyyyxxxy(xy)xxyyx
xyyyyxxxy(yx)xyxyx = xyyyyxxxy(xy)xyxyx
xyyyyxxxy(yx)xyyxx = xyyyyxxxy(xy)xyyxx
xyyyyxxx(yyx)yxxxy = xyyyyxxx(xyy)yxxxy
xyyyyxxxy(yx)yxxxy = xyyyyxxxy(xy)yxxxy
xyyyyxxxy(yx)yxxyx = xyyyyxxxy(xy)yxxyx
xyyyyxx(yxx)xxyyxy = xyyyyxx(xxy)xxyyxy
xyyyyxx(yx)xxxyyxy = xyyyyxx(xy)xxxyyxy
xyyyyxx(yxx)xxyyyx = xyyyyxx(xxy)xxyyyx
xyyyyxx(yx)xxxyyyx = xyyyyxx(xy)xxxyyyx
xyyyyxx(yxx)xyxyxy = xyyyyxx(xxy)xyxyxy
xyyyyxx(yxxxy)xyxy = xyyyyxx(xxyyx)xyxy
xyyyyxx(yx)xxyxyxy = xyyyyxx(xy)xxyxyxy
xyyyyxx(yxxxy)xyxy = xyyyyxx(xyxyx)xyxy
xyyyyxx(yxx)xyxyyx = xyyyyxx(xxy)xyxyyx
xyyyyxx(yxxxy)xyyx = xyyyyxx(xxyyx)xyyx
xyyyyxx(yx)xxyxyyx = xyyyyxx(xy)xxyxyyx
xyyyyxx(yxxxy)xyyx = xyyyyxx(xyxyx)xyyx
xyyyyxx(yxxxy)xyyx = xyyyyxx(xyyxx)xyyx
xyyyyxx(yxx)xyyxxy = xyyyyxx(xxy)xyyxxy
xyyyyxx(yxxxy)yxxy = xyyyyxx(xxyyx)yxxy
xyyyyxx(yx)xxyyxxy = xyyyyxx(xy)xxyyxxy
xyyyyxx(yxxxy)yxxy = xyyyyxx(xyxyx)yxxy
xyyyyxx(yxx)xyyxyx = xyyyyxx(xxy)xyyxyx
xyyyyxx(yx)xxyyxyx = xyyyyxx(xy)xxyyxyx
xyyyyxx(yxx)xyyyxx = xyyyyxx(xxy)xyyyxx
xyyyyxx(yx)xxyyyxx = xyyyyxx(xy)xxyyyxx
xyyyyxx(yxx)yxxxyy = xyyyyxx(xxy)yxxxyy
xyyyyxx(yx)xyxxxyy = xyyyyxx(xy)xyxxxyy
xyyyyxx(yxxyx)xyxy = xyyyyxx(xxyxy)xyxy
xyyyyxx(yxx)yxxyxy = xyyyyxx(xxy)yxxyxy
xyyyyxx(yxxyx)xyxy = xyyyyxx(xyxxy)xyxy
xyyyyxx(yx)xyxxyxy = xyyyyxx(xy)xyxxyxy
xyyyyxxyxx(yx)xyxy = xyyyyxxyxx(xy)xyxy
xyyyyxx(yxxyx)xyyx = xyyyyxx(xxyxy)xyyx
xyyyyxx(yxx)yxxyyx = xyyyyxx(xxy)yxxyyx
xyyyyxx(yxxyx)xyyx = xyyyyxx(xyxxy)xyyx
xyyyyxx(yx)xyxxyyx = xyyyyxx(xy)xyxxyyx
xyyyyxx(yxxy)xxyyx = xyyyyxx(xyyx)xxyyx
xyyyyxxyxx(yx)xyyx = xyyyyxxyxx(xy)xyyx
xyyyyxx(yxxyx)yxxy = xyyyyxx(xxyxy)yxxy
xyyyyxx(yxx)yxyxxy = xyyyyxx(xxy)yxyxxy
xyyyyxx(yxxyx)yxxy = xyyyyxx(xyxxy)yxxy
xyyyyxx(yx)xyxyxxy = xyyyyxx(xy)xyxyxxy
xyyyyxxyxx(yx)yxxy = xyyyyxxyxx(xy)yxxy
xyyyyxx(yx)xyxyxyx = xyyyyxx(xy)xyxyxyx
xyyyyxx(yxxy)xyxyx = xyyyyxx(xyyx)xyxyx
xyyyyxx(yx)xyxyyxx = xyyyyxx(xy)xyxyyxx
xyyyyxx(yxxy)xyyxx = xyyyyxx(xyyx)xyyxx
xyyyyxx(yxx)yyxxxy = xyyyyxx(xxy)yyxxxy
xyyyyxx(yx)xyyxxxy = xyyyyxx(xy)xyyxxxy
xyyyyxx(yxxy)yxxxy = xyyyyxx(xyyx)yxxxy
xyyyyxx(yx)xyyxxyx = xyyyyxx(xy)xyyxxyx
xyyyyxx(yxxy)yxxyx = xyyyyxx(xyyx)yxxyx
xyyyyxx(yx)xyyxyxx = xyyyyxx(xy)xyyxyxx
xyyyyxx(yx)xyyyxxx = xyyyyxx(xy)xyyyxxx
xyyyyxx(yx)yxxxxyy = xyyyyxx(xy)yxxxxyy
xyyyyxx(yx)yxxxyxy = xyyyyxx(xy)yxxxyxy
xyyyyxx(yxyxx)xyyx = xyyyyxx(xxyxy)xyyx
xyyyyxx(yxyx)xxyyx = xyyyyxx(xxyy)xxyyx
xyyyyxx(yxyxx)xyyx = xyyyyxx(xyxxy)xyyx
xyyyyxx(yxyx)xxyyx = xyyyyxx(xyxy)xxyyx
xyyyyxx(yx)yxxxyyx = xyyyyxx(xy)yxxxyyx
xyyyyxxyx(yxx)xyyx = xyyyyxxyx(xxy)xyyx
xyyyyxxyx(yx)xxyyx = xyyyyxxyx(xy)xxyyx
xyyyyxx(yx)yxxyxxy = xyyyyxx(xy)yxxyxxy
xyyyyxx(yxyx)xyxyx = xyyyyxx(xyxy)xyxyx
xyyyyxx(yx)yxxyxyx = xyyyyxx(xy)yxxyxyx
xyyyyxxyx(yx)xyxyx = xyyyyxxyx(xy)xyxyx
xyyyyxx(yxyx)xyyxx = xyyyyxx(xyxy)xyyxx
xyyyyxx(yx)yxxyyxx = xyyyyxx(xy)yxxyyxx
xyyyyxxyx(yx)xyyxx = xyyyyxxyx(xy)xyyxx
xyyyyxx(yxyx)yxxxy = xyyyyxx(xxyy)yxxxy
xyyyyxx(yxyx)yxxxy = xyyyyxx(xyxy)yxxxy
xyyyyxx(yx)yxyxxxy = xyyyyxx(xy)yxyxxxy
xyyyyxxyx(yx)yxxxy = xyyyyxxyx(xy)yxxxy
xyyyyxx(yxyx)yxxyx = xyyyyxx(xyxy)yxxyx
xyyyyxx(yx)yxyxxyx = xyyyyxx(xy)yxyxxyx
xyyyyxxyx(yx)yxxyx = xyyyyxxyx(xy)yxxyx
xyyyyxx(yx)yyxxxxy = xyyyyxx(xy)yyxxxxy
xyyyyxx(yx)yyxxxyx = xyyyyxx(xy)yyxxxyx
xyyyyxxyyxx(yx)xyx = xyyyyxxyyxx(xy)xyx
xyyyyxxy(yx)xyyxxx = xyyyyxxy(xy)xyyxxx
xyyyyxx(yyx)yxxxxy = xyyyyxx(xyy)yxxxxy
xyyyyxxy(yx)yxxxxy = xyyyyxxy(xy)yxxxxy
xyyyyxx(yyx)yxxxyx = xyyyyxx(xyy)yxxxyx
xyyyyxxy(yx)yxxxyx = xyyyyxxy(xy)yxxxyx
xyyyyxxy(yx)yxxyxx = xyyyyxxy(xy)yxxyxx
xyyyyxyxxx(yx)xyxy = xyyyyxyxxx(xy)xyxy
xyyyyxyxxx(yx)xyyx = xyyyyxyxxx(xy)xyyx
xyyyyxyxxx(yx)yxxy = xyyyyxyxxx(xy)yxxy
xyyyyx(yxx)xyyyxxx = xyyyyx(xxy)xyyyxxx
xyyyyx(yx)xxyyyxxx = xyyyyx(xy)xxyyyxxx
xyyyyxyxx(yxx)xyyx = xyyyyxyxx(xxy)xyyx
xyyyyxyxx(yx)xxyyx = xyyyyxyxx(xy)xxyyx
xyyyyxyxx(yxx)yxxy = xyyyyxyxx(xxy)yxxy
xyyyyxyxx(yx)xyxxy = xyyyyxyxx(xy)xyxxy
xyyyyxyxx(yx)xyxyx = xyyyyxyxx(xy)xyxyx
xyyyyxyxx(yx)xyyxx = xyyyyxyxx(xy)xyyxx
xyyyyxyxx(yx)yxxxy = xyyyyxyxx(xy)yxxxy
xyyyyxyxx(yx)yxxyx = xyyyyxyxx(xy)yxxyx
xyyyyx(yx)xyxyyxxx = xyyyyx(xy)xyxyyxxx
xyyyyx(yxxy)xyyxxx = xyyyyx(xyyx)xyyxxx
xyyyyx(yxx)yyxxxxy = xyyyyx(xxy)yyxxxxy
xyyyyx(yx)xyyxxxxy = xyyyyx(xy)xyyxxxxy
xyyyyx(yxxy)yxxxxy = xyyyyx(xyyx)yxxxxy
xyyyyx(yxx)yyxxxyx = xyyyyx(xxy)yyxxxyx
xyyyyx(yx)xyyxxxyx = xyyyyx(xy)xyyxxxyx
xyyyyx(yxxy)yxxxyx = xyyyyx(xyyx)yxxxyx
xyyyyx(yx)xyyxxyxx = xyyyyx(xy)xyyxxyxx
xyyyyx(yxxy)yxxyxx = xyyyyx(xyyx)yxxyxx
xyyyyx(yx)xyyxyxxx = xyyyyx(xy)xyyxyxxx
xyyyyx(yx)xyyyxxxx = xyyyyx(xy)xyyyxxxx
xyyyyx(yx)yxxxxxyy = xyyyyx(xy)yxxxxxyy
xyyyyx(yx)yxxxxyxy = xyyyyx(xy)yxxxxyxy
xyyyyx(yx)yxxxxyyx = xyyyyx(xy)yxxxxyyx
xyyyyx(yx)yxxxyxxy = xyyyyx(xy)yxxxyxxy
xyyyyx(yx)yxxxyxyx = xyyyyx(xy)yxxxyxyx
xyyyyx(yxyxxxy)xyx = xyyyyx(xyyxxyx)xyx
xyyyyx(yx)yxxxyyxx = xyyyyx(xy)yxxxyyxx
xyyyyx(yx)yxxyxxxy = xyyyyx(xy)yxxyxxxy
xyyyyx(yxyxxyx)xyx = xyyyyx(xyyxxxy)xyx
xyyyyx(yx)yxxyxxyx = xyyyyx(xy)yxxyxxyx
xyyyyxyxyxx(yx)xyx = xyyyyxyxyxx(xy)xyx
xyyyyx(yx)yxxyxyxx = xyyyyx(xy)yxxyxyxx
xyyyyx(yxyx)xyyxxx = xyyyyx(xyxy)xyyxxx
xyyyyx(yx)yxxyyxxx = xyyyyx(xy)yxxyyxxx
xyyyyxyx(yx)xyyxxx = xyyyyxyx(xy)xyyxxx
xyyyyx(yxyx)yxxxxy = xyyyyx(xxyy)yxxxxy
xyyyyx(yxyx)yxxxxy = xyyyyx(xyxy)yxxxxy
xyyyyx(yx)yxyxxxxy = xyyyyx(xy)yxyxxxxy
xyyyyxyx(yx)yxxxxy = xyyyyxyx(xy)yxxxxy
xyyyyx(yxyx)yxxxyx = xyyyyx(xxyy)yxxxyx
xyyyyx(yxyx)yxxxyx = xyyyyx(xyxy)yxxxyx
xyyyyx(yx)yxyxxxyx = xyyyyx(xy)yxyxxxyx
xyyyyxyx(yx)yxxxyx = xyyyyxyx(xy)yxxxyx
xyyyyx(yxyx)yxxyxx = xyyyyx(xyxy)yxxyxx
xyyyyx(yx)yxyxxyxx = xyyyyx(xy)yxyxxyxx
xyyyyxyx(yx)yxxyxx = xyyyyxyx(xy)yxxyxx
xyyyyx(yx)yxyxyxxx = xyyyyx(xy)yxyxyxxx
xyyyyx(yx)yxyyxxxx = xyyyyx(xy)yxyyxxxx
xyyyyx(yx)yyxxxxxy = xyyyyx(xy)yyxxxxxy
xyyyyx(yx)yyxxxxyx = xyyyyx(xy)yyxxxxyx
xyyyyx(yx)yyxxxyxx = xyyyyx(xy)yyxxxyxx
xyyyyx(yx)yyxxyxxx = xyyyyx(xy)yyxxyxxx
xyyyyxyyxxx(yx)xyx = xyyyyxyyxxx(xy)xyx
xyyyyxyyxx(yx)xyxx = xyyyyxyyxx(xy)xyxx
xyyyyyxxxx(yx)xyxy = xyyyyyxxxx(xy)xyxy
xyyyyyxxxx(yx)xyyx = xyyyyyxxxx(xy)xyyx
xyyyyyxxxx(yx)yxxy = xyyyyyxxxx(xy)yxxy
xyyyyyxxxxy(yx)xyx = xyyyyyxxxxy(xy)xyx
xyyyyyxxx(yxx)xyxy = xyyyyyxxx(xxy)xyxy
xyyyyyxxx(yx)xxyxy = xyyyyyxxx(xy)xxyxy
xyyyyyxxx(yxx)xyyx = xyyyyyxxx(xxy)xyyx
xyyyyyxxx(yx)xxyyx = xyyyyyxxx(xy)xxyyx
xyyyyyxxx(yxx)yxxy = xyyyyyxxx(xxy)yxxy
xyyyyyxxx(yx)xyxxy = xyyyyyxxx(xy)xyxxy
xyyyyyxxx(yx)xyxyx = xyyyyyxxx(xy)xyxyx
xyyyyyxxx(yxxy)xyx = xyyyyyxxx(xyyx)xyx
xyyyyyxxx(yx)xyyxx = xyyyyyxxx(xy)xyyxx
xyyyyyxxx(yx)yxxxy = xyyyyyxxx(xy)yxxxy
xyyyyyxxx(yxyx)xyx = xyyyyyxxx(xyxy)xyx
xyyyyyxxx(yx)yxxyx = xyyyyyxxx(xy)yxxyx
xyyyyyxxxyx(yx)xyx = xyyyyyxxxyx(xy)xyx
xyyyyyxx(yxxx)xyyx = xyyyyyxx(xxxy)xyyx
xyyyyyxx(yxx)xxyyx = xyyyyyxx(xxy)xxyyx
xyyyyyxx(yx)xxxyyx = xyyyyyxx(xy)xxxyyx
xyyyyyxx(yxx)xyxyx = xyyyyyxx(xxy)xyxyx
xyyyyyxx(yxxxy)xyx = xyyyyyxx(xxyyx)xyx
xyyyyyxx(yx)xxyxyx = xyyyyyxx(xy)xxyxyx
xyyyyyxx(yxxxy)xyx = xyyyyyxx(xyxyx)xyx
xyyyyyxx(yxx)xyyxx = xyyyyyxx(xxy)xyyxx
xyyyyyxx(yx)xxyyxx = xyyyyyxx(xy)xxyyxx
xyyyyyxx(yxx)yxxxy = xyyyyyxx(xxy)yxxxy
xyyyyyxx(yx)xyxxxy = xyyyyyxx(xy)xyxxxy
xyyyyyxx(yxxyx)xyx = xyyyyyxx(xxyxy)xyx
xyyyyyxx(yxx)yxxyx = xyyyyyxx(xxy)yxxyx
xyyyyyxx(yxxyx)xyx = xyyyyyxx(xyxxy)xyx
xyyyyyxx(yx)xyxxyx = xyyyyyxx(xy)xyxxyx
xyyyyyxxyxx(yx)xyx = xyyyyyxxyxx(xy)xyx
xyyyyyxx(yx)xyxyxx = xyyyyyxx(xy)xyxyxx
xyyyyyxx(yx)xyyxxx = xyyyyyxx(xy)xyyxxx
xyyyyyxx(yx)yxxxxy = xyyyyyxx(xy)yxxxxy
xyyyyyxx(yx)yxxxyx = xyyyyyxx(xy)yxxxyx
xyyyyyxx(yx)yxxyxx = xyyyyyxx(xy)yxxyxx
xyyyyyxyxxx(yx)xyx = xyyyyyxyxxx(xy)xyx
xyyyyyxyxx(yx)xyxx = xyyyyyxyxx(xy)xyxx
xyyyyyx(yx)xyyxxxx = xyyyyyx(xy)xyyxxxx
xyyyyyx(yx)yxxxxxy = xyyyyyx(xy)yxxxxxy
xyyyyyx(yx)yxxxxyx = xyyyyyx(xy)yxxxxyx
xyyyyyx(yx)yxxxyxx = xyyyyyx(xy)yxxxyxx
xyyyyyx(yx)yxxyxxx = xyyyyyx(xy)yxxyxxx
xyyyyyx(yx)yxyxxxx = xyyyyyx(xy)yxyxxxx
xyyyyyyxxxx(yx)xyx = xyyyyyyxxxx(xy)xyx
xyyyyyyxxx(yxx)xyx = xyyyyyyxxx(xxy)xyx
xyyyyyyxxx(yx)xxyx = xyyyyyyxxx(xy)xxyx
xyyyyyyxxx(yx)xyxx = xyyyyyyxxx(xy)xyxx
xyyyyyyxx(yx)xyxxx = xyyyyyyxx(xy)xyxxx
